circonscriptionId,delegationId,subDelegationId,centerID,stationId,registeredVoters,aSigningVoters,bDeliveredBallots,cSpoiledBallots,dLeftBallots,fExtractedBallots,gEplusF,hBminusG,iAminusF,jListVotes,kCancelledVotes,lBlankVotes,mJplusKplusL,nFminusM,countingStart,countingEnd,tampon,sebsi,marzouki,observers
12,4,4,64,1,284,154,300,0,146,154,300,0,0,147,5,2,154,0,1820,1900,True,103,44,sebsi:1  marzouki:1  
12,4,4,63,2,305,165,400,0,235,165,400,0,0,157,3,5,165,0,1815,1835,True,130,27,sebsi:1  marzouki:1  
12,4,4,63,1,305,215,400,1,184,215,400,0,0,206,5,4,215,0,1810,1910,True,188,18,sebsi:1  marzouki:1  
12,4,4,62,1,440,225,500,0,275,225,500,0,0,215,9,1,225,0,1817,1900,True,162,53,sebsi:1  marzouki:1  
12,4,4,61,1,376,262,400,0,138,262,400,0,0,257,4,1,262,0,1815,1910,True,147,110,sebsi:1  marzouki:1  
12,4,4,60,2,510,291,600,0,309,291,600,0,0,281,9,1,291,0,1805,1900,True,199,82,sebsi:1  marzouki:1  
12,4,4,60,1,511,365,600,0,235,365,600,0,0,353,8,4,365,0,1810,1850,True,280,73,sebsi:1  marzouki:1  
12,4,4,59,2,433,276,500,0,224,276,500,0,0,268,6,2,276,0,,,True,178,90,sebsi:1  marzouki:1  
12,4,4,59,1,433,335,500,1,164,335,500,0,0,327,4,4,335,0,1810,1900,True,278,49,sebsi:1  marzouki:1  
12,4,3,58,3,583,265,696,1,430,265,696,0,0,258,5,2,265,0,1805,1844,True,165,93,sebsi:1  marzouki:1  
12,4,3,58,1,585,426,700,0,274,426,700,0,0,417,3,6,426,0,1810,1901,True,352,65,sebsi:1  marzouki:1  
12,4,3,57,4,466,222,500,0,278,222,500,0,0,210,8,4,222,0,1805,1900,True,140,70,sebsi:1  marzouki:1  
12,4,3,57,3,469,278,500,0,222,278,500,0,0,269,6,3,278,0,1805,1902,True,181,88,sebsi:1  marzouki:1  
12,4,3,57,2,469,339,500,2,159,339,500,0,0,336,3,0,339,0,1810,1905,True,265,71,sebsi:1  marzouki:1  
12,4,3,57,1,469,353,500,1,146,353,500,0,0,345,4,4,353,0,1810,,True,300,45,sebsi:1  marzouki:1  
12,4,3,56,3,522,258,600,0,342,258,600,0,0,251,5,2,258,0,1810,1903,True,182,69,sebsi:1  marzouki:1  
12,4,3,56,2,523,353,600,0,247,353,600,0,0,343,5,5,353,0,1815,1850,True,270,73,sebsi:1  marzouki:1  
12,4,3,56,1,523,382,600,2,216,382,600,0,0,373,6,3,382,0,1815,1900,True,333,40,sebsi:1  marzouki:1  
12,4,3,55,3,411,246,500,1,253,246,500,0,0,238,7,1,246,0,1805,1905,True,150,88,sebsi:1  marzouki:1  
12,4,3,55,2,412,284,500,0,216,284,500,0,0,280,2,2,284,0,1815,1900,True,191,89,sebsi:1  marzouki:1  
12,4,3,55,1,412,312,499,0,187,312,499,0,0,307,5,0,312,0,1810,1900,True,252,55,sebsi:1  marzouki:1  
12,4,2,54,2,358,162,400,0,238,162,400,0,0,157,4,1,162,0,1815,1900,True,96,61,sebsi:1  marzouki:1  
12,4,2,54,1,358,254,400,0,146,254,400,0,0,248,5,1,254,0,1805,1842,True,198,50,sebsi:1  marzouki:1  
12,4,1,53,1,189,83,200,0,117,83,200,0,0,80,0,3,83,0,1815,1835,True,60,20,sebsi:1  marzouki:1  
12,4,1,52,1,460,255,500,0,245,255,500,0,0,244,5,6,255,0,1800,1836,True,215,29,sebsi:1  marzouki:1  
12,5,5,77,8,559,352,600,0,248,352,600,0,0,336,10,6,352,0,1800,2000,True,199,137,sebsi:1  marzouki:1  
12,5,5,77,7,561,303,600,0,297,303,600,0,0,295,7,1,303,0,1840,1920,True,164,131,sebsi:1  marzouki:1  
12,5,5,77,6,561,322,600,0,278,322,600,0,0,313,5,4,322,0,1815,1930,True,181,132,sebsi:1  marzouki:1  
12,5,5,77,5,561,393,600,0,207,393,600,0,0,386,3,4,393,0,1819,1900,True,224,162,sebsi:1  marzouki:1  
12,5,5,77,4,561,415,600,0,185,415,600,0,0,405,4,6,415,0,1815,1930,True,258,147,sebsi:1  marzouki:1  
12,5,5,77,3,561,441,599,0,158,441,599,0,0,432,5,4,441,0,1830,1950,True,301,131,sebsi:1  marzouki:1  
12,5,5,77,2,561,401,600,0,199,401,600,0,0,392,4,5,401,0,1825,1940,True,297,95,sebsi:1  marzouki:1  
12,5,5,77,1,561,441,600,0,159,441,600,0,0,437,3,1,441,0,1810,1920,True,329,108,sebsi:1  marzouki:1  
12,5,5,76,2,508,185,599,0,414,185,599,0,0,179,4,2,185,0,1808,1845,False,122,57,sebsi:1  marzouki:1  
12,5,5,76,1,508,292,600,0,308,292,600,0,0,284,2,6,292,0,1800,1855,True,227,57,sebsi:1  marzouki:1  
12,5,5,75,2,385,196,500,0,304,196,500,0,0,187,6,3,196,0,1810,1900,True,117,70,sebsi:1  marzouki:1  
12,5,5,75,1,386,237,501,1,263,237,501,0,0,230,4,3,237,0,1815,1910,True,156,74,sebsi:1  marzouki:1  
12,5,4,74,2,474,329,505,0,176,329,505,0,0,317,4,8,329,0,1815,1915,True,166,151,sebsi:1  marzouki:1  
12,5,4,74,1,474,398,509,0,111,398,509,0,0,388,2,8,398,0,1815,1925,True,242,146,sebsi:1  marzouki:1  
12,5,4,73,3,432,182,500,0,318,182,500,0,0,175,2,5,182,0,1810,1851,True,103,72,sebsi:1  marzouki:1  
12,5,4,73,2,433,241,500,0,259,241,500,0,0,236,3,2,241,0,1808,1855,True,152,84,sebsi:1  marzouki:1  
12,5,4,73,1,433,261,500,0,240,260,500,0,1,250,7,3,260,0,1815,1925,True,194,56,sebsi:1  marzouki:1  
12,5,4,72,5,519,308,600,1,291,308,600,0,0,292,6,10,308,0,1818,1900,True,171,121,sebsi:1  marzouki:1  
12,5,4,72,4,523,345,601,0,256,345,601,0,0,333,6,6,345,0,1820,1920,False,191,142,sebsi:1  marzouki:1  
12,5,4,72,3,523,378,601,1,222,378,601,0,0,372,5,1,378,0,1810,1910,False,212,160,sebsi:1  marzouki:1  
12,5,4,72,2,523,386,600,0,214,386,600,0,0,372,10,4,386,0,1810,1905,False,265,107,sebsi:1  marzouki:1  
12,5,4,72,1,523,411,600,1,188,411,600,0,0,397,10,4,411,0,1815,1910,False,283,114,sebsi:1  marzouki:1  
12,5,4,71,6,563,372,600,0,228,372,600,0,0,358,10,4,372,0,1815,1906,False,224,134,sebsi:1  marzouki:1  
12,5,4,71,5,565,368,600,0,232,368,600,0,0,355,2,11,368,0,1806,1937,True,205,150,sebsi:1  marzouki:1  
12,5,4,71,4,565,421,596,0,175,421,596,0,0,410,9,2,421,0,1820,1915,True,228,182,sebsi:1  marzouki:1  
12,5,4,71,3,565,428,601,1,172,428,601,0,0,416,7,5,428,0,1815,1915,False,239,177,sebsi:1  marzouki:1  
12,5,4,71,2,565,454,600,0,146,454,600,0,0,446,5,3,454,0,1820,1920,True,305,141,sebsi:1  marzouki:1  
12,5,4,71,1,565,437,600,1,162,437,600,0,0,423,8,6,437,0,1825,1940,True,308,115,sebsi:1  marzouki:1  
12,5,4,70,5,534,295,600,1,305,294,600,0,1,283,7,4,294,0,1820,1915,True,166,117,sebsi:2  marzouki:2  
12,5,4,70,4,538,315,600,0,285,315,600,0,0,309,3,3,315,0,1820,1905,False,191,118,sebsi:1  marzouki:1  
12,5,4,70,3,538,370,600,0,230,370,600,0,0,365,3,2,370,0,1815,1920,True,246,119,sebsi:2  marzouki:2  
12,5,4,70,2,538,388,600,0,212,388,600,0,0,374,12,2,388,0,1820,1930,True,259,115,sebsi:1  marzouki:1  
12,5,4,70,1,538,397,599,1,201,397,599,0,0,389,6,2,397,0,1800,1930,True,307,82,sebsi:1  marzouki:1  
12,5,3,69,3,483,246,600,0,354,246,600,0,0,238,1,7,246,0,1805,1842,True,136,102,sebsi:  marzouki:  
12,5,3,69,1,485,312,600,0,288,312,600,0,0,300,7,5,312,0,1815,1850,True,243,57,sebsi:1  marzouki:1  
12,5,2,68,2,564,261,596,1,334,261,596,0,0,251,8,2,261,0,1820,1900,True,152,99,sebsi:1  marzouki:1  
12,5,2,68,1,565,372,600,1,227,372,600,0,0,357,11,4,372,0,1830,2000,False,266,91,sebsi:1  marzouki:1  
12,5,2,67,4,449,160,500,1,339,160,500,0,0,153,6,1,160,0,1815,1900,True,108,45,sebsi:1  marzouki:1  
12,5,2,67,3,452,220,501,0,281,220,501,0,0,218,2,0,220,0,1820,1900,False,147,71,sebsi:1  marzouki:1  
12,5,2,67,2,452,291,501,0,210,291,501,0,0,287,2,2,291,0,1820,1900,True,205,82,sebsi:1  marzouki:1  
12,5,2,67,1,452,302,500,0,198,302,500,0,0,292,3,7,302,0,1810,1900,False,242,50,sebsi:1  marzouki:1  
12,5,1,66,1,267,196,300,1,103,196,300,0,0,194,0,2,196,0,1802,1853,True,155,39,sebsi:1  marzouki:1  
12,5,1,65,3,483,221,599,0,378,221,599,0,0,211,7,3,221,0,1800,1845,False,172,39,sebsi:1  marzouki:1  
12,5,1,65,2,484,308,604,0,296,308,604,0,0,297,11,0,308,0,1815,1850,True,261,36,sebsi:1  marzouki:1  
12,5,1,65,1,484,350,494,0,144,350,494,0,0,337,8,5,350,0,,,False,316,21,sebsi:1  marzouki:1  
12,7,5,114,1,399,239,500,0,261,239,500,0,0,231,8,0,239,0,1800,1900,True,206,25,sebsi:2  marzouki:1  
12,7,5,113,2,300,140,400,0,260,140,400,0,0,137,2,1,140,0,1815,1845,True,115,22,sebsi:1  marzouki:1  
12,7,5,113,1,301,218,400,0,182,218,400,0,0,210,7,1,218,0,1820,1906,True,188,22,sebsi:1  marzouki:1  
12,7,4,112,3,575,325,700,0,375,325,700,0,0,312,3,10,325,0,1830,1910,True,225,87,sebsi:1  marzouki:1  
12,7,4,112,2,577,416,700,0,284,416,700,0,0,405,5,6,416,0,,1915,True,307,98,sebsi:1  marzouki:1  
12,7,4,112,1,577,468,700,0,232,468,700,0,0,454,8,6,468,0,1815,1910,True,382,72,sebsi:1  marzouki:1  
12,7,3,111,1,510,229,600,0,371,229,600,0,0,222,7,0,229,0,1820,1900,True,188,34,sebsi:1  marzouki:1  
12,7,3,110,2,308,122,400,0,278,122,400,0,0,120,2,0,122,0,1810,1830,True,113,7,sebsi:1  marzouki:1  
12,7,3,110,1,308,192,400,0,208,192,400,0,0,188,3,1,192,0,0,1835,True,174,14,sebsi:1  marzouki:0  
12,7,3,109,7,579,334,700,0,366,334,700,0,0,322,5,7,334,0,1815,1905,True,220,102,sebsi:1  marzouki:1  
12,7,3,109,6,580,341,700,0,359,341,700,0,0,335,5,1,341,0,1830,1940,True,220,115,sebsi:1  marzouki:1  
12,7,3,109,5,580,375,700,0,325,375,700,0,0,368,4,3,375,0,1800,1930,True,263,105,sebsi:1  marzouki:1  
12,7,3,109,4,580,427,694,0,267,427,694,0,0,424,1,2,427,0,1810,1936,True,309,115,sebsi:1  marzouki:1  
12,7,3,109,3,580,452,704,0,252,452,704,0,0,435,17,0,452,0,1815,1952,True,332,103,sebsi:1  marzouki:1  
12,7,3,109,2,580,429,700,0,271,429,700,0,0,418,4,7,429,0,1811,1924,True,347,71,sebsi:1  marzouki:1  
12,7,3,109,1,580,442,700,1,257,442,700,0,0,428,11,3,442,0,1810,1920,True,353,75,sebsi:1  marzouki:1  
12,7,3,108,6,551,322,600,0,278,322,600,0,0,312,5,5,322,0,1815,1910,True,228,84,sebsi:1  marzouki:1  
12,7,3,108,5,555,307,607,7,293,307,607,0,0,300,3,4,307,0,,1938,True,226,74,sebsi:1  marzouki:1  
12,7,3,108,4,555,397,600,0,203,397,600,0,0,390,6,1,397,0,1815,1925,True,296,94,sebsi:1  marzouki:1  
12,7,3,108,3,555,416,616,0,200,416,616,0,0,413,2,1,416,0,1840,1900,True,313,100,sebsi:1  marzouki:1  
12,7,3,108,2,555,416,600,0,184,416,600,0,0,406,10,0,416,0,1805,1915,True,325,81,sebsi:1  marzouki:1  
12,7,3,108,1,555,447,600,0,153,447,600,0,0,434,9,4,447,0,1815,1925,True,371,63,sebsi:1  marzouki:1  
12,7,3,107,5,517,321,600,1,278,321,600,0,0,308,8,5,321,0,1800,1923,True,243,65,sebsi:1  marzouki:1  
12,7,3,107,4,519,324,600,0,276,324,600,0,0,320,4,0,324,0,1815,1910,True,238,82,sebsi:1  marzouki:1  
12,7,3,107,3,519,385,600,0,215,385,600,0,0,381,1,3,385,0,1800,1900,True,288,93,sebsi:1  marzouki:1  
12,7,3,107,2,519,415,601,3,183,415,601,0,0,406,7,2,415,0,1810,2010,True,339,67,sebsi:1  marzouki:1  
12,7,3,107,1,519,389,600,1,210,389,600,0,0,382,5,2,389,0,1810,1918,True,334,48,sebsi:1  marzouki:1  
12,7,3,106,3,445,269,500,0,231,269,500,0,0,254,8,7,269,0,1800,1900,True,207,47,sebsi:1  marzouki:1  
12,7,3,106,2,445,342,492,0,150,342,492,0,0,334,7,1,342,0,1835,1925,True,266,68,sebsi:1  marzouki:1  
12,7,3,106,1,445,363,496,0,133,363,496,0,0,358,4,1,363,0,1820,1902,True,307,51,sebsi:1  marzouki:1  
12,7,2,105,1,281,163,300,0,137,163,300,0,0,160,2,1,163,0,1804,1835,False,117,43,sebsi:1  marzouki:1  
12,7,2,104,1,557,313,600,0,287,313,600,0,0,298,10,5,313,0,1810,1850,True,273,25,sebsi:1  marzouki:1  
12,7,2,103,1,468,246,500,0,254,246,500,0,0,241,4,1,246,0,1820,1900,True,142,99,sebsi:1  marzouki:0  
12,7,2,102,2,401,164,500,0,336,164,500,0,0,160,3,1,164,0,1820,1840,True,126,34,sebsi:1  marzouki:1  
12,7,2,102,1,401,242,500,0,258,242,500,0,0,235,5,2,242,0,1810,1900,False,208,27,sebsi:1  marzouki:1  
12,7,2,101,2,526,202,600,0,398,202,600,0,0,198,3,1,202,0,1820,1900,True,114,84,sebsi:  marzouki:  
12,7,2,101,1,526,331,600,2,267,331,600,0,0,310,14,7,331,0,1817,1900,True,235,75,sebsi:  marzouki:  
12,7,1,100,1,393,192,500,0,308,192,500,0,0,189,3,0,192,0,1805,1840,True,148,41,sebsi:1  marzouki:1  
12,7,1,99,2,389,147,500,1,352,147,500,0,0,142,4,1,147,0,1800,1850,True,106,36,sebsi:1  marzouki:1  
12,7,1,99,1,389,236,500,0,264,236,500,0,0,226,8,2,236,0,1810,1855,True,186,40,sebsi:  marzouki:  
12,1,8,24,6,529,220,600,0,380,220,600,0,0,212,5,3,220,0,1815,1900,False,134,78,sebsi:1  marzouki:1  
12,1,8,24,5,533,284,596,0,312,284,596,0,0,276,3,5,284,0,1815,1850,False,181,95,sebsi:1  marzouki:1  
12,1,8,24,4,533,321,600,0,279,321,600,0,0,316,3,2,321,0,1815,1920,True,252,64,sebsi:1  marzouki:1  
12,1,8,24,3,533,323,600,0,277,323,600,0,0,318,4,1,323,0,1823,1948,False,251,67,sebsi:1  marzouki:1  
12,1,8,24,2,533,380,600,0,220,380,600,0,0,369,7,4,380,1,,2020,True,275,94,sebsi:1  marzouki:1  
12,1,8,24,1,533,418,600,0,182,418,600,0,0,415,0,3,418,0,1815,2000,True,344,71,sebsi:1  marzouki:1  
12,1,7,23,4,477,242,600,0,358,242,600,0,0,237,2,3,242,0,1800,1910,True,159,78,sebsi:1  marzouki:1  
12,1,7,23,3,479,265,591,0,326,265,591,0,0,263,1,1,265,0,1835,1908,True,175,88,sebsi:1  marzouki:1  
12,1,7,23,2,479,332,596,0,264,332,596,0,0,324,5,3,332,0,1815,1915,True,225,99,sebsi:1  marzouki:1  
12,1,7,23,1,479,362,600,0,238,362,362,238,0,349,9,4,362,0,1830,1915,True,254,95,sebsi:1  marzouki:1  
12,1,7,22,2,390,198,500,0,302,198,500,0,0,196,2,0,198,0,1800,,True,157,39,sebsi:1  marzouki:1  
12,1,7,22,1,391,267,500,0,233,267,500,0,0,265,0,2,267,0,1810,1850,True,223,42,sebsi:1  marzouki:1  
12,1,6,21,7,570,387,700,2,311,387,700,0,0,373,6,8,387,0,1805,1900,True,273,100,sebsi:1  marzouki:1  
12,1,6,21,6,575,378,700,1,321,378,700,0,0,357,14,7,378,0,1814,1909,False,264,93,sebsi:1  marzouki:1  
12,1,6,21,5,575,430,702,0,272,430,702,0,0,419,5,6,430,0,1820,1920,True,273,146,sebsi:1  marzouki:1  
12,1,6,21,4,575,459,700,0,241,459,700,0,0,448,7,4,459,0,1815,1910,True,298,150,sebsi:1  marzouki:1  
12,1,6,21,3,575,466,700,0,234,466,700,0,0,456,3,7,466,0,1820,1900,True,349,107,sebsi:1  marzouki:1  
12,1,6,21,2,575,478,697,0,219,478,697,0,0,473,3,2,478,0,1815,1925,True,363,110,sebsi:1  marzouki:1  
12,1,5,20,8,585,412,699,0,287,412,699,0,0,394,12,6,412,0,1820,1911,True,264,130,sebsi:1  marzouki:1  
12,1,5,20,7,590,357,700,0,343,357,700,0,0,347,5,5,357,0,1820,1900,True,207,140,sebsi:1  marzouki:1  
12,1,5,20,6,590,418,700,1,281,418,700,0,0,410,6,2,418,0,1820,1907,True,274,136,sebsi:1  marzouki:1  
12,1,5,20,5,590,476,700,0,224,476,700,0,0,468,4,4,476,0,1815,1900,True,325,143,sebsi:1  marzouki:1  
12,1,5,20,4,590,484,700,0,216,484,700,0,0,470,9,5,484,0,1800,1905,True,316,154,sebsi:1  marzouki:1  
12,1,5,20,3,590,445,700,0,255,445,700,0,0,442,2,1,445,0,1830,1930,True,323,119,sebsi:1  marzouki:1  
12,1,5,20,2,590,486,700,0,210,486,696,4,0,456,26,4,486,0,1815,2002,True,347,109,sebsi:1  marzouki:1  
12,1,5,20,1,590,485,700,0,215,485,700,0,0,470,12,3,485,0,1810,1940,True,368,102,sebsi:1  marzouki:1  
12,1,5,19,7,583,400,700,0,300,400,700,0,0,378,14,8,400,0,1810,1915,True,226,152,sebsi:1  marzouki:1  
12,1,5,19,6,588,346,702,0,356,346,702,0,0,339,5,2,346,0,1815,1920,True,199,140,sebsi:1  marzouki:1  
12,1,5,19,5,588,433,696,0,263,433,696,0,0,428,5,0,433,0,1840,1925,False,266,162,sebsi:1  marzouki:1  
12,1,5,19,4,588,490,696,0,206,490,696,0,0,486,3,1,490,0,1805,1910,True,307,179,sebsi:1  marzouki:1  
12,1,5,19,3,588,425,700,0,275,425,700,0,0,408,13,4,425,0,1820,1930,True,284,124,sebsi:1  marzouki:1  
12,1,5,19,2,588,480,700,1,219,480,700,0,0,455,23,2,480,0,1815,1955,True,326,129,sebsi:1  marzouki:1  
12,1,5,19,1,588,492,699,0,207,492,699,0,0,489,2,1,492,0,1810,1930,True,350,139,sebsi:1  marzouki:1  
12,1,5,18,8,537,388,600,0,212,388,600,0,0,376,4,8,388,0,1800,1910,True,272,104,sebsi:1  marzouki:1  
12,1,5,18,7,540,304,600,0,296,304,600,0,0,297,5,2,304,0,1815,1910,True,207,90,sebsi:1  marzouki:1  
12,1,5,18,6,540,386,596,0,210,386,596,0,0,376,4,6,386,0,1815,1920,True,246,130,sebsi:1  marzouki:1  
12,1,5,18,5,540,431,600,0,169,431,600,0,0,424,3,4,431,0,1810,1925,True,276,148,sebsi:1  marzouki:1  
12,1,5,18,4,540,441,596,0,155,441,596,0,0,430,4,7,441,0,1800,1910,False,279,151,sebsi:1  marzouki:1  
12,1,5,18,3,540,407,600,0,193,407,600,0,0,404,1,2,407,0,1815,1855,False,299,105,sebsi:1  marzouki:1  
12,1,5,18,2,540,450,600,0,150,450,600,0,0,439,7,4,450,0,1800,1915,False,327,112,sebsi:1  marzouki:1  
12,1,5,18,1,540,432,600,1,167,432,600,0,0,420,8,4,432,0,1815,1924,False,343,77,sebsi:1  marzouki:1  
12,1,5,17,5,585,327,700,0,373,327,700,0,0,321,3,3,327,0,1820,1910,True,229,92,sebsi:1  marzouki:1  
12,1,5,17,4,585,359,700,1,340,359,700,0,0,357,1,1,359,0,1810,1909,True,239,118,sebsi:1  marzouki:1  
12,1,5,17,3,585,430,700,0,270,430,700,0,0,424,3,3,430,0,1830,2000,True,308,116,sebsi:1  marzouki:1  
12,1,5,17,2,585,428,700,0,272,428,700,0,0,419,5,4,428,0,1815,1930,True,318,101,sebsi:1  marzouki:1  
12,1,5,17,1,585,455,700,0,245,455,700,0,0,442,10,3,455,0,1812,1918,True,371,71,sebsi:1  marzouki:1  
12,1,5,16,4,507,287,600,0,313,287,600,0,0,275,8,4,287,0,1825,1915,True,203,72,sebsi:1  marzouki:1  
12,1,5,16,3,509,347,600,0,253,347,600,0,0,340,6,1,347,0,1812,1930,True,247,93,sebsi:1  marzouki:1  
12,1,5,16,2,509,372,604,0,232,372,604,0,0,364,5,3,372,0,1815,1920,True,271,93,sebsi:1  marzouki:1  
12,1,5,16,1,509,417,600,0,183,417,600,0,0,406,6,5,417,0,1800,1900,False,331,75,sebsi:1  marzouki:1  
12,1,4,15,4,516,190,600,0,410,190,600,0,0,187,3,0,190,0,1815,1845,True,131,56,sebsi:1  marzouki:1  
12,1,4,15,3,516,237,602,1,364,237,602,0,0,233,2,2,237,0,1820,1850,True,165,68,sebsi:1  marzouki:1  
12,1,4,15,2,516,277,600,0,323,277,600,0,0,274,0,3,277,0,1825,1901,True,203,71,sebsi:1  marzouki:1  
12,1,4,15,1,516,317,596,0,279,317,596,0,0,310,2,5,317,0,1815,1919,True,230,80,sebsi:1  marzouki:1  
12,1,4,14,2,569,301,600,1,298,301,600,0,0,294,6,1,301,0,,1900,True,169,125,sebsi:1  marzouki:1  
12,1,4,14,1,570,379,600,0,221,379,600,0,0,370,6,3,379,0,1815,1901,True,258,112,sebsi:1  marzouki:1  
12,1,4,13,2,462,244,500,0,256,244,500,0,0,240,3,1,244,0,1810,1905,True,177,63,sebsi:1  marzouki:1  
12,1,4,13,1,463,319,500,0,181,319,500,0,0,317,1,1,319,0,1820,1906,True,247,70,sebsi:2  marzouki:2  
12,1,4,12,8,547,246,600,0,354,246,600,0,0,240,3,3,246,0,1820,1900,True,171,69,sebsi:1  marzouki:1  
12,1,4,12,7,554,251,598,0,347,251,598,0,0,248,1,2,251,0,1820,1905,True,140,108,sebsi:1  marzouki:1  
12,1,4,12,6,554,288,596,0,308,288,596,0,0,287,1,0,288,0,1822,1928,True,184,103,sebsi:1  marzouki:1  
12,1,4,12,5,554,359,600,0,243,357,600,0,2,349,8,0,357,0,1815,1930,True,238,111,sebsi:1  marzouki:1  
12,1,4,12,4,554,381,600,1,218,381,600,0,0,375,6,0,381,0,1820,1910,True,248,127,sebsi:1  marzouki:1  :  
12,1,4,12,3,554,396,600,0,204,396,600,0,0,392,3,1,396,0,1820,1920,True,276,116,sebsi:1  marzouki:1  :  
12,1,4,12,2,554,423,600,0,177,423,600,0,0,415,3,5,423,0,,1915,True,328,87,sebsi:1  marzouki:1  :  
12,1,4,12,1,554,413,600,1,187,412,600,0,1,396,8,8,412,0,1830,1958,True,329,67,sebsi:1  marzouki:1  :  
12,1,3,11,4,474,281,501,0,220,281,501,0,0,275,5,1,281,0,1815,1900,True,202,73,sebsi:1  marzouki:1  :  
12,1,3,11,3,474,306,475,1,168,306,475,0,0,302,2,2,306,0,1815,1910,True,222,80,sebsi:1  marzouki:1  
12,1,3,11,2,474,350,500,1,149,350,500,0,0,336,7,7,350,0,1815,1915,True,254,82,sebsi:1  marzouki:1  
12,1,3,11,1,474,363,498,1,134,363,498,0,0,351,5,7,363,0,1820,1915,True,296,55,sebsi:1  marzouki:1  
12,1,3,10,1,519,330,600,0,270,330,600,0,0,322,6,2,330,0,1830,1900,True,262,60,sebsi:1  marzouki:1  
12,1,3,9,5,513,265,599,0,334,265,599,0,0,261,3,1,265,0,1812,1905,True,162,99,sebsi:1  marzouki:1  
12,1,3,9,4,516,259,600,0,341,259,600,0,0,253,3,3,259,0,1800,1902,True,177,76,sebsi:1  marzouki:1  
12,1,3,9,3,516,355,600,0,245,355,600,0,0,346,6,3,355,0,1800,1910,False,257,89,sebsi:1  marzouki:1  
12,1,3,9,2,516,385,600,0,215,385,600,0,0,375,8,2,385,0,1810,1905,True,268,107,sebsi:1  marzouki:1  
12,1,3,9,1,516,381,600,0,219,381,600,0,0,364,13,4,381,0,1805,1905,True,301,63,sebsi:1  marzouki:1  
12,1,2,8,1,429,248,503,0,255,248,503,0,0,240,2,6,248,0,1817,1845,True,205,35,sebsi:1  marzouki:1  
12,1,2,6,2,373,169,400,0,231,169,400,0,0,163,4,2,169,0,1830,1900,True,96,67,sebsi:1  marzouki:1  
12,1,1,5,1,354,210,400,0,190,210,400,0,0,206,4,0,210,0,1810,1840,True,176,30,sebsi:1  marzouki:1  
12,1,1,4,1,498,274,600,0,326,274,600,0,0,265,6,3,274,0,1815,1900,True,220,45,sebsi:1  marzouki:1  
12,1,1,3,1,244,143,300,0,157,143,300,0,0,134,8,1,143,0,1805,1820,True,106,28,sebsi:1  marzouki:1  
12,1,1,2,1,365,229,400,1,170,229,400,0,0,221,4,4,229,0,1815,1900,True,149,72,sebsi:1  marzouki:1  
12,1,1,1,3,590,276,700,0,424,276,700,0,0,270,4,2,276,0,1815,1848,True,165,105,sebsi:1  marzouki:1  
12,1,1,1,2,591,352,700,0,348,352,700,0,0,347,2,3,352,0,1810,1908,True,219,128,sebsi:1  marzouki:1  
12,1,1,1,1,591,365,700,0,335,365,700,0,0,359,4,2,365,0,1815,0,True,275,84,sebsi:1  marzouki:1  
12,6,9,98,3,412,142,500,1,357,142,500,0,0,133,5,4,142,0,1810,1850,False,80,53,sebsi:1  marzouki:1  
12,6,9,98,2,412,228,500,0,272,228,500,0,0,218,9,1,228,0,1800,1915,True,151,67,sebsi:1  marzouki:1  
12,6,9,98,1,412,266,501,0,235,266,501,0,0,256,1,9,266,0,1800,1905,False,214,42,sebsi:1  marzouki:1  
12,6,8,97,1,335,160,400,0,240,160,400,0,0,152,7,1,160,0,1830,1900,True,126,26,sebsi:2  marzouki:2  
12,6,8,96,1,516,246,600,0,354,246,600,0,0,238,5,3,246,0,1810,1845,True,167,71,sebsi:1  marzouki:1  
12,6,7,95,2,409,212,500,0,288,212,500,0,0,210,0,2,212,0,1815,1850,False,125,85,sebsi:1  marzouki:1  
12,6,7,95,1,409,259,500,0,241,259,500,0,0,252,5,2,259,0,1800,1925,False,205,47,sebsi:1  marzouki:1  
12,6,7,94,2,429,304,500,0,196,304,500,0,0,299,4,1,304,0,10800,1930,False,65,234,sebsi:1  marzouki:1  
12,6,7,94,1,430,334,500,0,166,334,500,0,0,330,2,2,334,0,1830,1910,True,103,227,sebsi:1  marzouki:1  
12,6,7,93,4,451,234,500,0,266,234,500,0,0,224,7,3,234,0,1820,1847,True,135,89,sebsi:1  marzouki:1  
12,6,7,93,3,453,285,500,1,214,285,500,0,0,276,8,1,285,0,1820,1920,True,163,113,sebsi:1  marzouki:1  
12,6,7,93,2,500,323,500,0,177,323,500,0,0,317,4,2,323,0,1840,1940,True,211,106,sebsi:1  marzouki:1  
12,6,7,93,1,453,344,500,1,156,343,500,0,1,326,15,2,343,0,1815,1930,True,217,109,sebsi:1  marzouki:1  
12,6,7,92,4,565,299,600,0,302,298,600,0,1,290,6,2,298,0,1850,1940,True,156,134,sebsi:1  marzouki:1  
12,6,7,92,3,565,358,600,0,242,358,600,0,0,352,5,1,358,0,1805,1655,True,216,136,sebsi:1  marzouki:1  
12,6,7,92,2,565,403,600,0,197,403,600,0,0,395,6,2,403,0,1800,1915,True,225,170,sebsi:1  marzouki:1  
12,6,7,92,1,565,435,598,0,163,435,598,0,0,426,8,1,435,0,1815,1920,True,333,93,sebsi:1  marzouki:1  
12,6,7,91,7,529,265,600,0,335,265,600,0,0,254,5,6,265,0,1809,1845,True,141,113,sebsi:1  marzouki:1  
12,6,7,91,6,532,233,599,0,366,233,599,0,0,232,0,1,233,0,1810,1825,True,120,112,sebsi:1  marzouki:1  
12,6,7,91,5,532,286,600,0,314,286,600,0,0,279,5,2,286,0,1810,1840,True,172,107,sebsi:1  marzouki:1  
12,6,7,91,4,532,322,600,0,278,322,600,0,0,313,4,5,322,0,1800,,True,194,119,sebsi:1  marzouki:1  
12,6,7,91,3,532,337,600,0,263,337,600,0,0,332,4,1,337,0,1805,1854,True,225,107,sebsi:1  marzouki:1  
12,6,7,91,2,532,367,600,0,233,367,600,0,0,365,2,0,367,0,1805,1900,True,269,96,sebsi:1  marzouki:1  
12,6,7,91,1,532,363,599,1,235,363,599,0,0,357,3,3,363,0,1810,1905,True,274,83,sebsi:1  marzouki:1  
12,6,6,90,8,562,383,591,0,208,383,591,0,0,362,16,5,383,0,1820,2000,True,197,165,sebsi:1  marzouki:1  
12,6,6,90,7,564,325,600,0,275,325,600,0,0,313,9,3,325,0,1824,1945,True,166,147,sebsi:1  marzouki:1  
12,6,6,90,6,564,375,600,0,225,375,600,0,0,371,3,1,375,0,1800,1850,True,219,152,sebsi:1  marzouki:1  
12,6,6,90,5,564,412,600,0,188,412,600,0,0,408,2,2,412,0,1830,1930,True,209,199,sebsi:1  marzouki:1  
12,6,6,90,4,564,446,600,0,154,446,600,0,0,438,8,0,446,0,1820,1930,True,245,193,sebsi:1  marzouki:1  
12,6,6,90,3,564,445,600,0,155,445,600,0,0,437,6,2,445,0,1815,1920,False,272,165,sebsi:1  marzouki:1  
12,6,6,90,2,564,457,600,1,143,456,600,0,1,450,6,0,456,0,1820,1950,True,310,140,sebsi:1  marzouki:1  
12,6,6,90,1,564,453,596,2,142,452,596,0,1,435,15,2,452,0,1830,1930,True,299,136,sebsi:1  marzouki:1  
12,6,6,89,4,549,344,600,0,256,344,600,0,0,333,7,4,344,0,1830,1930,True,170,163,sebsi:1  marzouki:1  
12,6,6,89,3,550,383,600,0,217,383,600,0,0,379,2,2,383,0,1805,1930,True,250,129,sebsi:1  marzouki:1  
12,6,6,89,2,550,428,616,3,185,428,616,0,0,420,7,1,428,0,1820,1925,True,236,184,sebsi:1  marzouki:1  
12,6,6,89,1,550,462,600,0,138,462,600,0,0,458,3,1,462,0,1822,1945,True,314,144,sebsi:1  marzouki:1  
12,6,5,88,1,483,234,600,0,366,234,600,0,0,231,2,1,234,0,1805,1830,True,173,58,sebsi:1  marzouki:1  
12,6,5,87,2,454,311,497,1,185,311,497,0,0,307,3,1,311,0,1830,1940,True,164,143,sebsi:1  marzouki:1  
12,6,5,87,1,454,320,500,0,180,320,500,0,0,314,4,2,320,0,1800,1910,True,191,123,sebsi:1  marzouki:1  
12,6,4,86,1,366,244,392,0,148,244,392,0,0,240,2,2,244,0,,1845,True,172,68,sebsi:1  marzouki:1  
12,6,4,85,3,519,324,600,0,276,324,600,0,0,317,5,2,324,0,1820,1910,True,194,123,sebsi:1  marzouki:1  
12,6,4,85,2,521,370,597,0,227,370,597,0,0,365,4,1,370,0,1830,1920,False,274,91,sebsi:1  marzouki:1  
12,6,4,85,1,521,406,600,0,194,406,600,0,0,391,10,5,406,0,1820,1930,True,314,77,sebsi:1  marzouki:1  
12,6,3,84,5,495,303,600,0,297,303,600,0,0,292,6,5,303,0,1800,1855,True,206,86,sebsi:1  marzouki:1  
12,6,3,84,4,497,322,600,0,278,322,600,0,0,315,5,2,322,0,1815,1900,True,251,64,sebsi:1  marzouki:1  
12,6,3,84,3,497,361,600,1,238,361,600,0,0,353,7,1,361,0,1810,1900,True,261,92,sebsi:1  marzouki:1  
12,6,3,84,2,497,365,600,0,235,365,600,0,0,353,8,4,365,0,1800,1900,True,279,74,sebsi:1  marzouki:1  
12,6,3,84,1,497,405,592,2,185,405,592,0,0,392,9,4,405,0,1800,,True,351,41,sebsi:1  marzouki:1  
12,6,2,83,2,359,228,400,0,172,228,400,0,0,218,6,4,228,0,1840,1916,True,110,108,sebsi:1  marzouki:1  
12,6,2,83,1,359,274,400,0,126,274,400,0,0,270,1,3,274,0,1800,1900,True,149,121,sebsi:1  marzouki:1  
12,6,1,82,3,469,237,500,1,262,237,500,0,0,226,6,5,237,0,1815,1845,True,120,106,sebsi:1  marzouki:1  
12,6,1,82,2,470,306,500,0,194,306,500,0,0,299,5,2,306,0,1800,1900,True,209,90,sebsi:1  marzouki:1  
12,6,1,82,1,470,339,500,2,159,339,500,0,0,329,6,4,339,0,1815,1900,True,257,72,sebsi:1  marzouki:1  
12,6,1,81,3,486,249,601,0,352,249,601,0,0,243,2,4,249,0,1830,1900,True,126,117,sebsi:1  marzouki:1  
12,6,1,81,2,487,338,600,1,261,338,600,0,0,335,2,1,338,0,1800,1900,True,177,158,sebsi:1  marzouki:1  
12,6,1,81,1,487,348,600,0,252,348,600,0,0,339,8,1,348,0,1810,1905,True,211,128,sebsi:1  marzouki:1  
12,6,1,80,1,39,20,100,0,80,20,100,0,0,19,1,0,20,0,1820,1835,True,6,13,sebsi:1  marzouki:1  
12,6,1,79,2,579,366,700,0,334,366,700,0,0,362,3,1,366,0,1815,1907,True,213,149,sebsi:1  marzouki:1  
12,6,1,79,1,580,450,702,0,252,450,702,0,0,446,3,1,450,0,1815,1930,True,267,179,sebsi:  marzouki:  
12,6,1,78,4,545,268,600,0,332,268,600,0,0,262,5,1,268,0,1800,1900,True,142,120,sebsi:1  marzouki:1  
12,6,1,78,3,548,332,600,0,268,332,600,0,0,325,4,3,332,0,1815,1920,True,207,118,sebsi:1  marzouki:1  
12,6,1,78,2,548,368,600,0,232,368,600,0,0,361,4,3,368,0,1800,1858,True,248,113,sebsi:1  marzouki:1  
12,6,1,78,1,548,386,600,0,214,386,600,0,0,371,12,3,386,0,1810,1915,True,300,71,sebsi:1  marzouki:1  
12,3,7,51,2,568,314,600,1,285,314,600,0,0,309,3,2,314,0,1810,1900,False,233,76,sebsi:1  marzouki:1  
12,3,7,51,1,569,386,600,0,214,386,600,0,0,377,8,1,386,0,1815,,False,332,45,sebsi:1  marzouki:1  
12,3,6,50,3,463,266,500,0,234,266,500,0,0,258,3,5,266,0,1815,1902,False,217,41,sebsi:1  marzouki:1  
12,3,6,50,2,463,329,500,0,171,329,500,0,0,323,2,4,329,0,1815,1930,True,266,57,sebsi:1  marzouki:1  
12,3,6,50,1,463,339,500,0,161,339,500,0,0,334,2,3,339,0,1805,1845,False,300,34,sebsi:1  marzouki:1  
12,3,6,49,1,103,65,200,0,135,65,200,0,0,64,1,0,65,0,1800,,True,59,5,sebsi:1  marzouki:1  
12,3,6,48,2,594,388,696,0,308,388,696,0,0,383,2,3,388,0,1810,1856,True,245,138,sebsi:1  marzouki:1  
12,3,6,48,1,594,431,700,0,269,431,700,0,0,421,8,2,431,0,1800,1930,True,308,113,sebsi:1  marzouki:1  
12,3,5,47,1,373,185,400,0,215,185,400,0,0,176,7,2,185,0,1810,1850,True,144,32,sebsi:1  marzouki:1  
12,3,5,46,2,471,259,500,0,241,259,500,0,0,251,5,3,259,0,1815,1844,True,182,69,sebsi:1  marzouki:1  
12,3,5,46,1,471,314,500,2,184,314,500,0,0,301,6,7,314,0,1800,1855,False,254,47,sebsi:1  marzouki:1  
12,3,5,45,2,506,265,600,0,335,265,600,0,0,257,6,2,265,0,1815,1844,False,141,116,sebsi:1  marzouki:1  
12,3,5,45,1,507,329,600,1,270,329,600,0,0,314,11,4,329,0,1815,,True,202,112,sebsi:1  marzouki:1  
12,3,5,44,2,377,206,400,0,194,206,400,0,0,202,2,2,206,0,18.15,18.35,False,91,111,sebsi:1  marzouki:1  
12,3,5,44,1,378,235,400,0,165,235,400,0,0,224,10,1,235,0,1820,1845,True,146,78,sebsi:1  marzouki:1  
12,3,4,43,3,452,267,500,1,233,266,500,0,1,256,8,2,266,0,1805,1900,False,170,86,sebsi:1  marzouki:1  
12,3,4,43,1,452,350,500,0,150,350,500,0,0,340,8,2,350,0,1813,1900,True,268,72,sebsi:1  marzouki:1  
12,3,4,42,1,448,296,500,0,204,296,500,0,0,285,6,5,296,0,1820,1920,True,153,132,sebsi:1  marzouki:1  
12,3,4,41,4,554,339,600,0,261,339,600,0,0,328,9,2,339,0,1837,1930,True,180,148,sebsi:1  marzouki:1  
12,3,4,41,3,556,354,600,0,246,354,600,0,0,345,4,5,354,0,1810,1900,True,212,133,sebsi:1  marzouki:1  
12,3,4,41,2,556,385,600,0,215,385,600,0,0,378,7,0,385,0,1805,1900,True,234,144,sebsi:1  marzouki:1  
12,3,4,41,1,556,422,600,0,177,423,600,0,1,416,5,2,423,0,1800,2000,True,323,93,sebsi:1  marzouki:1  
12,3,3,40,2,439,233,500,0,267,233,500,0,0,227,4,2,233,0,1818,2000,True,158,69,sebsi:1  marzouki:1  
12,3,3,40,1,439,297,500,1,202,297,500,0,0,283,8,6,297,0,1815,1939,True,205,78,sebsi:1  marzouki:1  
12,3,2,39,3,549,310,596,0,286,310,596,0,0,303,5,2,310,0,1805,1855,True,139,164,sebsi:1  marzouki:1  
12,3,2,39,2,551,341,600,0,259,341,600,0,0,331,6,4,341,0,1810,1900,True,167,164,sebsi:1  marzouki:1  
12,3,2,39,1,551,364,600,0,236,364,600,0,0,352,4,8,364,0,1800,1920,False,231,121,sebsi:1  marzouki:1  
12,3,1,38,3,488,309,591,0,282,309,591,0,0,298,7,4,309,0,1800,,True,174,124,sebsi:1  marzouki:1  
12,3,1,38,2,490,361,600,1,238,361,600,0,0,347,9,5,361,0,1815,1905,True,216,131,sebsi:1  marzouki:1  
12,3,1,38,1,490,360,609,1,248,360,609,0,0,349,5,6,360,0,1805,1930,False,263,86,sebsi:1  marzouki:1  
12,2,6,37,2,359,177,400,0,223,177,400,0,0,169,6,2,177,0,1800,1840,False,116,53,sebsi:1  marzouki:1  
12,2,6,37,1,360,268,400,0,132,268,400,0,0,260,4,4,268,0,1800,1845,True,182,78,sebsi:1  marzouki:1  
12,2,5,36,1,405,263,500,0,237,263,500,0,0,257,5,1,263,0,1810,1900,True,188,69,sebsi:1  marzouki:1  
12,2,5,35,1,521,270,600,0,330,270,600,0,0,265,1,4,270,0,1824,1900,True,207,58,sebsi:1  marzouki:1  
12,2,5,34,2,411,172,500,0,328,172,500,0,0,170,1,1,172,0,,1840,True,117,53,sebsi:1  marzouki:1  
12,2,5,34,1,412,281,500,1,218,281,500,0,0,277,0,4,281,0,18.10,18.45,True,238,39,sebsi:1  marzouki:1  
12,2,4,33,1,543,347,598,0,251,347,598,0,0,336,7,4,347,0,1830,2000,True,253,83,sebsi:1  marzouki:1  
12,2,4,32,2,482,256,600,0,344,256,600,0,0,252,0,4,256,0,1820,1912,False,182,70,sebsi:1  marzouki:1  
12,2,4,32,1,482,337,599,0,262,337,599,0,0,316,21,0,337,0,1805,1925,False,256,60,sebsi:1  marzouki:1  
12,2,4,31,2,309,177,400,1,222,177,400,0,0,171,4,2,177,0,1815,1850,True,132,39,sebsi:1  marzouki:1  
12,2,4,31,1,310,229,400,0,171,229,400,0,0,219,6,4,229,0,1810,1851,True,184,35,sebsi:1  marzouki:1  
12,2,3,30,1,191,136,300,0,164,136,300,0,0,134,2,0,136,0,1800,1835,False,105,29,sebsi:1  marzouki:1  
12,2,3,29,6,512,280,600,0,320,280,600,0,0,272,5,3,280,0,1815,,False,187,85,sebsi:1  marzouki:1  
12,2,3,29,5,512,271,600,0,329,271,600,0,0,268,3,0,271,0,1800,1900,False,160,108,sebsi:1  marzouki:1  
12,2,3,29,4,512,306,600,0,294,306,600,0,0,299,4,3,306,0,1805,1905,True,203,96,sebsi:1  marzouki:1  
12,2,3,29,3,512,350,600,2,248,350,600,0,0,332,16,2,350,0,1800,1900,False,228,104,sebsi:1  marzouki:1  
12,2,3,29,2,512,354,600,2,244,354,600,0,0,345,7,2,354,0,1815,1907,True,239,106,sebsi:1  marzouki:1  
12,2,3,29,1,512,391,600,0,209,391,600,0,0,376,10,5,391,0,1800,1915,True,288,88,sebsi:1  marzouki:1  
12,2,2,28,3,408,148,501,0,353,148,501,0,0,142,6,0,148,0,1815,1845,True,97,45,sebsi:1  marzouki:1  
12,2,2,28,2,410,233,500,0,267,233,500,0,0,222,8,3,233,0,1820,1907,True,158,64,sebsi:1  marzouki:1  
12,2,2,28,1,410,267,501,1,233,267,501,0,0,256,5,6,267,0,1808,1848,True,190,66,sebsi:1  marzouki:1  
12,2,1,27,2,462,237,500,0,263,237,500,0,0,227,5,5,237,0,1815,1845,False,146,81,sebsi:1  marzouki:1  
12,2,1,27,1,463,289,500,0,211,289,500,0,0,282,5,2,289,0,1812,1900,True,211,71,sebsi:1  marzouki:1  
12,2,1,26,7,582,363,700,0,337,363,700,0,0,355,3,5,363,0,1823,1920,False,238,117,sebsi:1  marzouki:1  
12,2,1,26,6,587,313,700,0,387,313,700,0,0,301,7,5,313,0,1835,1925,False,192,109,sebsi:1  marzouki:1  
12,2,1,26,5,587,361,700,0,339,361,700,0,0,350,3,8,361,0,1830,1935,False,242,108,sebsi:1  marzouki:1  
12,2,1,26,4,587,380,701,0,321,380,701,0,0,368,7,5,380,0,1830,1940,False,253,115,sebsi:1  marzouki:1  
12,2,1,26,3,587,403,700,0,297,403,700,0,0,393,7,3,403,0,1833,1930,False,285,108,sebsi:1  marzouki:1  
12,2,1,26,2,587,417,702,0,285,417,702,0,0,409,7,1,417,0,1820,1930,False,319,90,sebsi:1  marzouki:1  
12,2,1,26,1,587,439,700,0,261,439,700,0,0,430,6,3,439,0,1830,1956,True,349,81,sebsi:1  marzouki:1  
12,2,1,25,8,563,361,600,0,239,361,600,0,0,337,15,9,361,0,1805,1912,True,215,122,sebsi:1  marzouki:1  
12,2,1,25,7,570,312,599,0,287,312,599,0,0,304,6,2,312,0,1810,1900,True,192,112,sebsi:1  marzouki:1  
12,2,1,25,6,570,345,600,0,256,344,600,0,1,333,5,6,344,0,1820,1908,False,210,123,sebsi:1  marzouki:1  
12,2,1,25,5,570,404,600,0,196,404,600,0,0,394,9,1,404,0,1800,1905,True,253,141,sebsi:1  marzouki:1  
12,2,1,25,4,570,412,600,1,187,412,600,0,0,405,4,3,412,0,1800,1930,True,276,129,sebsi:1  marzouki:1  
12,2,1,25,3,570,431,600,1,168,431,600,0,0,419,4,8,431,0,1800,1910,False,290,129,sebsi:1  marzouki:1  
12,2,1,25,2,570,419,600,0,181,419,600,0,0,398,11,10,419,0,1810,1932,False,320,78,sebsi:1  marzouki:1  
12,2,1,25,1,570,457,600,2,143,454,599,1,3,434,11,9,454,0,1810,1920,False,341,93,sebsi:1  marzouki:1  
