circonscriptionId,delegationId,subDelegationId,centerID,stationId,registeredVoters,aSigningVoters,bDeliveredBallots,cSpoiledBallots,dLeftBallots,fExtractedBallots,gEplusF,hBminusG,iAminusF,jListVotes,kCancelledVotes,lBlankVotes,mJplusKplusL,nFminusM,countingStart,countingEnd,tampon,sebsi,marzouki,observers
15,5,6,78,1,407,138,500,0,362,138,500,0,0,133,2,3,138,0,1800,1903,True,80,53,sebsi:275  marzouki:1  
15,5,6,77,1,429,153,500,0,347,153,500,0,0,141,12,0,153,0,1815,1900,True,103,38,sebsi:275  marzouki:1  
15,5,5,76,1,331,150,396,1,245,150,396,0,0,129,20,1,150,0,1810,1850,True,78,51,sebsi:275  marzouki:1  
15,5,4,75,1,135,57,200,0,143,57,200,0,0,55,2,0,57,0,,1829,True,24,31,sebsi:275  marzouki:1  
15,5,4,74,1,116,58,200,0,142,58,200,0,0,56,1,1,58,0,1900,,True,27,29,sebsi:275  marzouki:1  
15,5,4,73,3,447,145,500,0,355,145,500,0,0,142,2,1,145,0,1815,1900,True,58,84,sebsi:275  marzouki:1  
15,5,4,73,2,448,231,499,0,268,231,499,0,0,228,3,0,231,0,1810,,True,118,110,sebsi:275  marzouki:1  
15,5,4,73,1,448,226,500,0,274,226,500,0,0,207,18,1,226,0,1810,1905,False,126,81,sebsi:275  marzouki:1  
15,5,3,72,1,110,56,200,0,144,56,200,0,0,56,0,0,56,0,1802,1802,True,35,21,sebsi:275  marzouki:1  
15,5,3,71,1,312,148,400,1,251,148,400,0,0,144,3,1,148,0,1800,1845,False,81,63,sebsi:275  marzouki:1  
15,5,3,70,1,529,305,600,1,294,305,600,0,0,290,12,3,305,0,1830,1900,True,188,102,sebsi:275  marzouki:1  
15,5,2,69,4,547,265,600,0,335,265,600,0,0,258,5,2,265,0,,1900,True,107,151,sebsi:275  marzouki:1  
15,5,2,69,3,549,302,600,1,297,302,600,0,0,296,2,4,302,0,1810,1849,True,142,154,sebsi:275  marzouki:1  
15,5,2,69,2,549,376,600,1,223,376,600,0,0,361,8,7,376,0,1800,1930,True,205,156,sebsi:275  marzouki:1  
15,5,2,69,1,549,380,600,0,220,380,600,0,0,355,24,1,380,0,1815,1920,True,225,130,sebsi:275  marzouki:1  
15,5,2,68,3,431,215,500,0,285,215,500,0,0,213,2,0,215,0,1805,1834,False,86,127,sebsi:275  marzouki:1  
15,5,2,68,2,433,281,500,0,219,281,500,0,0,273,5,3,281,0,1830,1902,True,173,100,sebsi:275  marzouki:1  
15,5,2,68,1,433,290,500,0,210,290,500,0,0,284,3,3,290,0,1811,1912,True,204,80,sebsi:275  marzouki:1  
15,5,2,67,2,514,232,600,1,367,232,600,0,0,226,6,0,232,0,1805,1855,True,131,95,sebsi:275  marzouki:1  
15,5,2,67,1,514,343,600,0,257,343,600,0,0,333,3,7,343,0,1820,1925,True,253,80,sebsi:275  marzouki:1  
15,5,2,66,5,508,225,600,0,375,225,600,0,0,217,6,2,225,0,1810,1842,True,91,126,sebsi:275  marzouki:1  
15,5,2,66,4,510,261,600,0,339,261,600,0,0,254,6,1,261,0,1810,1900,True,108,146,sebsi:275  marzouki:1  
15,9,3,145,1,209,86,300,0,214,86,300,0,0,82,4,0,86,0,1815,1840,True,37,45,sebsi:1  marzouki:1  
15,9,3,144,2,321,82,400,0,318,82,400,0,0,80,2,0,82,0,1802,1830,True,12,68,sebsi:1  marzouki:1  
15,9,3,144,1,321,126,400,0,274,126,400,0,0,119,5,2,126,0,,1820,True,27,92,sebsi:1  marzouki:1  
15,9,2,143,1,346,133,398,0,265,133,398,0,0,128,4,1,133,0,1810,1830,True,83,45,sebsi:1  marzouki:1  
15,10,14,210,1,349,75,400,0,325,75,400,0,0,74,0,1,75,0,1500,1530,True,41,33,sebsi:1  marzouki:1  
15,10,14,209,1,192,72,298,0,226,72,298,0,0,71,1,0,72,0,1815,1835,False,34,37,sebsi:1  marzouki:1  
15,10,14,208,2,333,74,400,0,326,74,400,0,0,74,0,0,74,0,1810,1850,True,41,33,sebsi:1  marzouki:1  
15,10,14,208,1,334,137,400,0,263,137,400,0,0,136,1,0,137,0,1808,1845,True,85,51,sebsi:1  marzouki:1  
15,10,13,207,1,194,109,300,0,191,109,300,0,0,109,0,0,109,0,1830,1930,True,34,75,sebsi:1  marzouki:1  
15,10,13,206,1,178,87,200,0,113,87,200,0,0,86,1,0,87,0,1815,1840,False,37,49,sebsi:1  marzouki:1  
15,10,13,205,1,400,224,500,0,276,224,500,0,0,222,2,0,224,0,1816,1840,False,40,182,sebsi:1  marzouki:1  
15,10,13,203,1,490,219,600,1,380,219,600,0,0,218,1,0,219,0,1500,1600,False,85,133,sebsi:1  marzouki:1  
15,10,13,202,1,361,159,400,1,240,159,400,0,0,156,3,0,159,0,,,False,70,86,sebsi:1  marzouki:1  
15,10,13,201,1,480,276,601,0,325,276,601,0,0,268,7,1,276,0,1815,1910,True,59,209,sebsi:1  marzouki:1  
15,10,12,200,2,554,151,600,0,449,151,600,0,0,151,0,0,151,0,1805,1900,True,20,131,sebsi:1  marzouki:1  
15,10,12,200,1,555,270,600,0,330,270,600,0,0,269,0,1,270,0,1815,1915,False,41,228,sebsi:1  marzouki:1  
15,10,12,199,1,167,50,200,0,150,50,200,0,0,50,0,0,50,0,1805,1830,False,10,40,sebsi:1  marzouki:1  
15,10,11,198,1,244,107,300,0,193,107,300,0,0,103,4,0,107,0,1800,1830,True,61,42,sebsi:1  marzouki:1  
15,10,11,197,2,594,230,700,0,470,230,700,0,0,208,19,3,230,0,,1900,False,149,59,sebsi:1  marzouki:1  
15,10,11,197,1,595,344,700,0,356,344,700,0,0,331,9,4,344,0,1825,1915,False,239,92,sebsi:1  marzouki:1  
15,10,10,196,2,421,173,496,0,323,173,496,0,0,167,4,2,173,0,1815,1855,False,135,32,sebsi:1  marzouki:1  
15,10,10,196,1,421,233,500,0,267,233,500,0,0,230,3,0,233,0,1805,1845,False,192,38,sebsi:1  marzouki:1  
15,10,10,195,1,385,185,500,0,315,185,500,0,0,185,0,0,185,0,1815,1845.,True,170,15,sebsi:1  marzouki:1  
15,10,10,194,2,345,88,400,0,312,88,400,0,0,85,3,0,88,0,1820,1900,False,59,26,sebsi:1  marzouki:1  
15,10,10,194,1,346,149,400,0,251,149,400,0,0,142,5,2,149,0,1805,1830,True,118,24,sebsi:1  marzouki:1  
15,10,9,193,1,147,43,200,0,157,43,200,0,0,42,1,0,43,0,1500,1549,True,28,14,sebsi:1  marzouki:1  
15,10,9,192,1,209,68,300,0,232,68,300,0,0,66,0,2,68,0,1808,1824,True,39,27,sebsi:1  marzouki:1  
15,10,9,191,1,462,226,496,0,270,226,496,0,0,213,12,1,226,0,1530,1630,True,88,125,sebsi:1  marzouki:1  
15,10,9,190,1,438,181,500,0,319,181,500,0,0,173,8,0,181,0,1530,1550,True,101,72,sebsi:1  marzouki:1  
15,10,9,189,2,321,87,400,0,313,87,400,0,0,84,2,1,87,0,1500,1530,False,38,46,sebsi:1  marzouki:1  
15,10,9,189,1,321,153,400,0,246,153,399,1,0,146,5,2,153,0,1515,1545,True,77,69,sebsi:1  marzouki:1  
15,10,8,188,1,170,68,200,0,132,68,200,0,0,65,3,0,68,0,1514,1541,False,29,36,sebsi:  marzouki:  
15,10,8,187,1,404,211,500,0,289,211,500,0,0,205,5,1,211,0,1845,,True,134,71,sebsi:  marzouki:  
15,10,8,186,1,287,112,400,0,288,112,400,0,0,107,5,0,112,0,1515,1530,True,63,44,sebsi:  marzouki:  
15,10,8,185,1,179,76,200,0,125,75,200,0,0,73,1,1,75,0,1800,,False,42,31,sebsi:  marzouki:  
15,10,8,184,1,433,147,500,0,353,147,500,0,0,140,7,0,147,0,1500,1550,False,48,92,sebsi:  marzouki:  
15,10,7,183,1,253,85,300,0,215,85,300,0,0,85,0,0,85,0,1820,1900,True,48,37,sebsi:  marzouki:  
15,10,7,182,2,592,114,700,0,586,114,700,0,0,110,2,2,114,0,1805,1830,False,70,40,sebsi:  marzouki:  
15,10,6,181,1,216,82,300,0,218,82,300,0,0,77,3,2,82,0,1515,1556,True,22,55,sebsi:  marzouki:  
15,10,6,180,1,72,17,100,0,83,17,100,0,0,17,0,0,17,0,1500,1515,False,8,9,sebsi:  marzouki:  
15,10,6,179,2,318,99,400,0,301,99,400,0,0,95,4,0,99,0,1520,1540,True,39,56,sebsi:  marzouki:  
15,10,6,179,1,318,159,400,0,241,159,400,0,0,150,6,3,159,0,1500,1600,True,92,58,sebsi:  marzouki:  
15,10,6,178,1,253,76,300,0,224,76,300,0,0,73,1,2,76,0,1530,1555,True,46,27,sebsi:  marzouki:  
15,10,6,177,1,400,120,400,0,280,120,400,0,0,118,2,0,120,0,,1540,True,52,66,sebsi:  marzouki:  
15,10,5,176,1,269,120,300,1,179,120,300,0,0,116,4,0,120,0,1515,1545,True,62,54,sebsi:  marzouki:  
15,10,5,175,2,378,146,396,0,250,146,396,0,0,144,1,1,146,0,1815,1900,True,41,103,sebsi:  marzouki:  
15,10,5,175,1,379,212,400,0,188,212,400,0,0,203,7,2,212,0,1800,1910,True,115,88,sebsi:  marzouki:  
15,10,5,174,1,384,154,500,1,345,154,500,0,0,151,3,0,154,0,1820,1850,True,89,62,sebsi:  marzouki:  
15,10,4,173,1,271,153,300,0,147,153,300,0,0,152,0,1,153,0,1508,1545,True,13,139,sebsi:  marzouki:  
15,10,4,172,1,100,28,200,0,172,28,200,0,0,27,0,1,28,0,2003,2203,False,13,14,sebsi:1  marzouki:1  
15,10,4,171,1,274,117,300,0,183,117,300,0,0,117,0,0,117,0,1515,1530,False,18,99,sebsi:1  marzouki:1  
15,10,4,170,2,488,203,600,0,397,203,600,0,0,202,0,1,203,0,1820,1845,True,17,185,sebsi:1  marzouki:1  
15,10,4,170,1,489,300,599,0,299,300,599,0,0,292,8,0,300,0,1804,,True,34,258,sebsi:1  marzouki:1  
15,10,3,169,1,415,169,500,0,331,169,500,0,0,161,7,1,169,0,1515,1600,True,73,88,sebsi:1  marzouki:1  
15,10,3,168,1,399,129,500,0,371,129,500,0,0,125,2,2,129,0,1503,1600,True,39,86,sebsi:1  marzouki:1  
15,10,3,167,1,423,135,500,0,365,135,500,0,0,130,5,0,135,0,1505,1535,True,45,85,sebsi:1  marzouki:1  
15,10,2,166,2,442,180,500,1,319,180,500,0,0,171,8,1,180,0,1819,1857,True,117,54,sebsi:1  marzouki:1  
15,10,2,166,1,443,271,500,0,229,271,500,0,0,259,3,9,271,0,1815,1922,True,193,66,sebsi:1  marzouki:1  
15,10,2,165,6,504,206,600,0,394,206,600,0,0,200,5,1,206,0,1808,1841,True,125,75,sebsi:1  marzouki:1  
15,10,2,165,5,504,231,600,0,369,231,600,0,0,229,2,0,231,0,1835,1855,True,133,96,sebsi:1  marzouki:1  
15,10,2,165,4,504,269,600,0,331,269,600,0,0,261,8,0,269,0,1820,1910,True,169,92,sebsi:1  marzouki:1  
15,10,2,165,3,504,352,599,0,247,352,599,0,0,346,4,2,352,0,1822,1858,True,229,117,sebsi:1  marzouki:1  
15,10,2,165,2,504,328,600,0,272,328,600,0,0,317,8,3,328,0,1810,1905,True,215,102,sebsi:1  marzouki:1  
15,10,2,165,1,504,336,600,1,263,336,600,0,0,311,22,3,336,0,1810,1900,True,229,82,sebsi:1  marzouki:1  
15,10,1,164,5,554,188,600,0,412,188,600,0,0,183,4,1,188,0,1815,1850,True,76,107,sebsi:1  marzouki:1  
15,10,1,164,4,558,242,600,0,358,242,600,0,0,238,2,2,242,0,1815,1855,True,99,139,sebsi:1  marzouki:1  
15,10,1,164,3,558,307,600,0,293,307,600,0,0,304,2,1,307,0,1810,1915,True,136,168,sebsi:1  marzouki:1  
15,10,1,164,2,558,382,600,2,216,382,600,0,0,373,6,3,382,0,1800,1946,True,195,178,sebsi:1  marzouki:1  
15,13,7,301,1,167,84,200,0,116,84,200,0,0,83,1,0,84,0,1810,1840,True,45,38,sebsi:  marzouki:  
15,13,7,300,1,44,20,100,0,80,20,100,0,0,19,0,1,20,0,1805,1845,True,18,1,sebsi:  marzouki:  
15,13,7,299,1,264,91,300,0,209,91,300,0,0,89,2,0,91,0,1800,1835,False,70,19,sebsi:1  marzouki:1  
15,13,6,298,3,410,183,500,0,317,183,500,0,0,177,3,3,183,0,1800,1840,True,79,98,sebsi:1  marzouki:1  
15,13,6,298,2,412,229,500,1,270,229,500,0,0,225,1,3,229,0,1815,1905,True,100,125,sebsi:1  marzouki:1  
15,13,6,297,1,411,142,500,1,357,142,500,0,0,137,4,1,142,0,1815,1835,True,96,41,sebsi:1  marzouki:1  
15,13,6,295,1,225,104,300,0,196,104,300,0,0,100,3,1,104,0,1810,1835,True,47,53,sebsi:1  marzouki:1  
15,13,5,294,1,310,144,400,0,256,144,400,0,0,141,1,2,144,0,1800,1830,False,58,83,sebsi:1  marzouki:1  
15,13,4,293,1,220,85,300,0,215,85,300,0,0,81,3,1,85,0,1810,1822,True,54,27,sebsi:1  marzouki:1  
15,13,4,292,2,305,163,400,0,237,163,400,0,0,160,3,0,163,0,1808,1826,True,43,117,sebsi:1  marzouki:1  
15,13,4,292,1,306,168,400,1,232,167,400,0,0,162,4,1,167,0,1800,1830,True,63,99,sebsi:1  marzouki:1  
15,13,3,291,1,256,145,300,0,155,145,300,0,0,143,2,0,145,0,1805,1827,True,106,37,sebsi:1  marzouki:1  
15,13,3,289,1,196,91,300,0,209,91,300,0,0,86,2,3,91,0,1806,1855,True,57,29,sebsi:  marzouki:  
15,13,3,288,1,269,127,300,0,173,127,300,0,0,126,1,0,127,0,1810,1830,True,72,54,sebsi:  marzouki:  
15,13,3,287,1,339,151,396,0,245,151,396,0,0,147,3,1,151,0,1810,1841,True,75,72,sebsi:  marzouki:  
15,13,1,280,1,187,72,200,0,128,72,200,0,0,69,3,0,72,0,1800,1830,True,49,20,sebsi:  marzouki:  
15,13,1,279,1,363,206,400,0,294,106,400,0,0,102,4,0,106,0,1800,1830,False,50,52,sebsi:  marzouki:  
15,13,1,278,4,520,245,601,1,355,245,601,0,0,235,5,5,245,0,,,False,59,176,sebsi:  marzouki:  
15,13,1,278,3,523,284,600,0,316,284,600,0,0,281,3,0,284,0,1805,1850,True,97,184,sebsi:  marzouki:  
15,13,1,278,2,523,363,600,0,237,363,600,0,0,357,4,2,363,0,1810,1900,True,146,211,sebsi:  marzouki:  
15,13,1,278,1,523,362,600,0,238,362,600,0,0,356,0,6,362,0,1805,1842,True,200,156,sebsi:  marzouki:  
15,3,6,47,2,330,100,400,0,300,100,400,0,0,97,0,3,100,0,1510,1533,True,44,53,sebsi:1  marzouki:1  
15,3,6,47,1,331,171,400,0,229,171,400,0,0,163,6,2,171,0,1512,1545,True,105,58,sebsi:1  marzouki:1  
15,3,5,46,2,371,206,400,0,194,206,400,0,0,199,3,4,206,0,1810,1840,True,73,126,sebsi:1  marzouki:1  
15,3,5,46,1,371,233,400,0,167,233,400,0,0,226,3,4,233,0,1805,1830,True,110,116,sebsi:1  marzouki:1  
15,3,5,45,1,217,102,300,0,198,102,300,0,0,101,1,0,102,0,1505,1525,True,54,47,sebsi:1  marzouki:1  
15,3,4,44,1,284,161,300,0,139,161,300,0,0,160,1,0,161,0,1810,1835,True,80,80,sebsi:1  marzouki:1  
15,3,4,43,2,353,117,400,0,282,117,399,1,0,115,1,1,117,0,,1835,True,54,61,sebsi:1  marzouki:1  
15,3,4,43,1,353,175,400,0,225,175,400,0,0,170,1,4,175,0,1800,1836,True,83,87,sebsi:1  marzouki:1  
15,3,4,42,1,345,201,400,0,199,201,400,0,0,198,3,0,201,0,1815,1845,False,95,103,sebsi:1  marzouki:1  
15,3,4,41,1,293,134,400,0,266,134,400,0,0,133,1,0,134,0,1505,1540,True,67,66,sebsi:1  marzouki:1  
15,3,4,40,2,338,163,400,0,237,163,400,0,0,161,2,0,163,0,1810,1900,True,58,103,sebsi:1  marzouki:1  
15,3,4,40,1,339,197,396,0,199,197,396,0,0,189,5,3,197,0,1810,1902,True,102,87,sebsi:1  marzouki:1  
15,3,4,39,4,508,254,600,0,346,254,600,0,0,246,5,3,254,0,1810,1859,False,84,162,sebsi:1  marzouki:1  
15,3,4,39,3,509,256,600,0,344,256,600,0,0,253,3,0,256,0,1805,1837,True,93,160,sebsi:1  marzouki:1  
15,3,4,39,2,509,355,600,0,245,355,600,0,0,352,0,3,355,0,1805,19002,True,156,196,sebsi:1  marzouki:1  
15,3,4,39,1,509,328,600,1,271,328,600,0,0,310,16,2,328,0,1818,1948,True,178,132,sebsi:1  marzouki:1  
15,3,3,38,1,106,68,200,1,131,68,200,0,0,68,0,0,68,0,1506,1518,True,20,48,sebsi:1  marzouki:1  
15,3,3,37,1,401,172,500,0,328,172,500,0,0,168,3,1,172,0,1810,1835,True,54,114,sebsi:1  marzouki:1  
15,3,3,36,1,62,35,100,1,65,35,101,1,0,35,0,0,35,0,1800,1815,True,4,30,sebsi:1  marzouki:1  
15,3,3,35,1,501,237,598,0,361,237,598,0,0,232,1,4,237,0,1800,1900,True,67,165,sebsi:1  marzouki:1  
15,3,3,34,1,168,67,200,0,133,67,200,0,0,64,3,0,67,0,1805,1830,True,46,18,sebsi:1  marzouki:1  
15,3,2,33,1,164,98,200,0,102,98,200,0,0,95,1,2,98,0,1805,1830,True,69,26,sebsi:1  marzouki:1  
15,3,2,32,1,242,111,300,0,189,111,300,0,0,107,4,0,111,0,1800,1830,True,36,71,sebsi:1  marzouki:1  
15,3,2,31,1,135,101,200,0,99,101,200,0,0,100,1,0,101,0,1800,1830,True,12,88,sebsi:1  marzouki:1  
15,3,2,30,1,205,103,300,0,197,103,300,0,0,101,0,2,103,0,1830,1900,True,27,74,sebsi:1  marzouki:1  
15,3,1,29,1,340,186,400,0,214,186,400,0,0,182,2,2,186,0,1800,1900,True,83,99,sebsi:1  marzouki:1  
15,3,1,28,1,300,152,400,0,248,152,400,0,0,149,2,1,152,0,1815,1835,True,98,51,sebsi:1  marzouki:1  
15,3,1,27,1,316,159,400,2,239,159,400,0,0,156,2,1,159,0,1500,1550,True,65,91,sebsi:1  marzouki:1  
15,3,1,26,1,234,98,300,0,202,98,300,0,0,97,0,1,98,0,1500,1525,True,50,47,sebsi:1  marzouki:1  
15,3,1,25,1,93,32,100,0,68,32,100,0,0,32,0,0,32,0,1505,1520,True,18,14,sebsi:1  marzouki:1  
15,4,6,64,1,371,298,400,0,102,298,400,0,0,291,4,3,298,0,1813,1925,True,132,159,sebsi:275  marzouki:1  
15,4,6,63,4,575,235,700,0,465,235,700,0,0,231,3,1,235,0,1900,,True,85,146,sebsi:275  marzouki:1  
15,4,6,63,3,576,279,700,0,421,279,700,0,0,272,2,5,279,0,1815,1905,True,131,141,sebsi:275  marzouki:1  
15,4,6,63,2,576,359,700,1,340,359,700,0,0,351,8,0,359,0,1804,1930,True,171,180,sebsi:275  marzouki:1  
15,4,6,63,1,576,349,698,0,349,349,698,0,0,340,9,0,349,0,,1930,True,204,136,sebsi:275  marzouki:1  
15,4,5,62,1,519,306,600,0,294,306,600,0,0,299,6,1,306,0,1820,1920,True,118,181,sebsi:275  marzouki:1  
15,4,4,61,6,589,304,700,2,395,303,700,0,1,295,4,4,303,0,1815,1922,True,97,198,sebsi:275  marzouki:1  
15,4,4,61,5,589,254,703,0,449,254,703,0,0,249,4,1,254,0,1815,1900,True,91,158,sebsi:275  marzouki:1  
15,4,4,61,4,589,354,696,0,342,354,696,0,0,345,8,1,354,0,1815,1910,True,120,225,sebsi:275  marzouki:1  
15,4,4,61,3,589,398,700,0,302,398,700,0,0,387,9,2,398,0,1815,1916,True,150,237,sebsi:275  marzouki:1  
15,4,4,61,2,589,453,700,1,247,552,700,0,1,442,4,6,452,0,1805,1930,True,224,218,sebsi:275  marzouki:1  
15,4,4,61,1,589,434,704,2,270,432,704,0,2,423,9,0,432,0,1815,1920,True,259,164,sebsi:275  marzouki:1  
15,4,3,60,5,501,234,601,0,367,234,601,0,0,229,4,1,234,0,1810,1933,True,49,180,sebsi:275  marzouki:1  
15,4,3,60,4,501,235,605,0,370,235,605,0,0,230,4,1,235,0,1811,1856,True,62,168,sebsi:275  marzouki:1  
15,4,3,60,3,501,280,600,0,320,280,600,0,0,275,1,4,280,0,1812,1849,True,85,190,sebsi:275  marzouki:1  
15,4,3,60,2,501,325,600,0,276,324,600,0,0,314,10,0,324,0,1810,1901,True,119,195,sebsi:275  marzouki:1  
15,4,3,60,1,501,336,600,0,264,336,600,0,0,321,11,4,336,0,1810,1900,True,142,179,sebsi:275  marzouki:1  
15,4,3,59,4,566,284,600,0,316,284,600,0,0,277,5,2,284,0,1815,1901,True,77,200,sebsi:275  marzouki:1  
15,4,3,59,3,568,307,600,0,293,307,600,0,0,303,1,3,307,0,1815,1900,True,81,222,sebsi:275  marzouki:1  
15,4,3,59,2,568,342,600,0,258,342,600,0,0,336,2,4,342,0,1800,1919,True,129,207,sebsi:275  marzouki:1  
15,4,3,59,1,568,375,600,0,225,375,600,0,0,359,13,3,375,0,1815,1930,True,204,155,sebsi:275  marzouki:1  
15,4,3,58,4,579,263,696,0,433,263,696,0,0,256,7,0,263,0,1827,1919,True,87,169,sebsi:275  marzouki:1  
15,4,3,58,3,581,299,700,0,401,299,700,0,0,290,8,1,299,0,1820,1900,True,114,176,sebsi:275  marzouki:1  
15,4,3,58,2,581,373,700,2,325,373,700,0,0,366,5,2,373,0,1810,1910,True,163,203,sebsi:1  marzouki:1  
15,4,3,58,1,581,386,700,1,313,386,700,0,0,367,17,2,386,0,1828,1926,True,202,165,sebsi:1  marzouki:1  
15,4,3,57,2,367,159,401,0,242,159,401,0,0,157,1,1,159,0,1800,1835,True,67,90,sebsi:1  marzouki:1  
15,4,3,57,1,367,226,400,1,173,226,400,0,0,223,1,2,226,0,1805,1855,True,122,101,sebsi:1  marzouki:1  
15,4,2,56,5,548,266,600,0,334,266,600,0,0,261,5,0,266,0,1820,1900,True,81,180,sebsi:1  marzouki:1  
15,4,2,56,4,548,293,600,1,306,293,600,0,0,286,2,5,293,0,1815,1900,True,97,189,sebsi:1  marzouki:1  
15,4,2,56,3,548,333,600,1,266,333,600,0,0,330,1,2,333,0,1815,1920,True,133,197,sebsi:1  marzouki:1  
15,4,2,56,2,548,407,600,1,192,407,600,0,0,402,4,1,407,0,1815,1930,True,190,212,sebsi:1  marzouki:1  
15,4,2,56,1,548,363,600,0,237,363,600,0,0,344,19,0,363,0,1815,1940,True,189,155,sebsi:1  marzouki:1  
15,4,2,55,5,506,252,596,0,344,252,496,0,0,250,0,2,252,0,1805,1841,True,86,164,sebsi:1  marzouki:1  
15,4,2,55,4,506,265,600,0,335,265,600,0,0,264,1,0,265,0,1815,1905,True,91,173,sebsi:1  marzouki:1  
15,4,2,55,3,506,313,600,0,287,313,600,0,0,309,4,0,313,0,1810,1851,True,130,179,sebsi:1  marzouki:1  
15,4,2,55,2,506,339,600,2,259,339,600,0,0,329,6,4,339,0,1810,1857,True,159,170,sebsi:1  marzouki:1  
15,4,2,55,1,506,391,596,2,205,389,596,0,0,379,8,2,389,0,1813,1922,True,238,141,sebsi:1  marzouki:1  
15,4,2,54,2,593,280,700,0,420,280,700,0,0,275,4,1,280,0,1815,1846,True,103,172,sebsi:275  marzouki:1  
15,4,2,54,1,593,378,700,0,322,378,700,0,0,362,16,0,378,0,1815,1900,True,203,159,sebsi:1  marzouki:1  
15,4,1,53,2,335,146,400,0,254,146,400,0,0,145,0,1,146,0,1500,1540,True,29,116,sebsi:1  marzouki:1  
15,4,1,53,1,335,169,400,1,230,169,400,0,0,163,6,0,169,0,1515,1545,True,57,106,sebsi:1  marzouki:1  
15,4,1,52,1,436,255,500,0,245,255,500,0,0,251,1,3,255,0,1810,1838,True,120,131,sebsi:1  marzouki:1  
15,4,1,51,5,481,208,600,0,392,208,600,0,0,205,3,0,208,0,1800,1840,True,74,131,sebsi:1  marzouki:1  
15,4,1,51,4,481,203,600,0,397,203,600,0,0,200,2,1,203,0,1800,1845,True,68,132,sebsi:1  marzouki:1  
15,4,1,51,3,481,256,600,1,333,256,600,0,0,257,2,7,266,0,1800,1905,True,104,153,sebsi:1  marzouki:1  
15,4,1,51,2,481,292,600,0,308,292,600,0,0,286,5,1,292,0,1816,1920,True,130,156,sebsi:1  marzouki:1  
15,4,1,51,1,481,297,600,0,303,297,600,0,0,287,4,6,297,0,1810,1900,True,187,100,sebsi:1  marzouki:1  
15,4,1,50,7,581,259,700,4,437,259,700,0,0,252,6,1,259,0,1817,1849,True,77,175,sebsi:1  marzouki:1  
15,4,1,49,7,567,320,601,0,281,320,601,0,0,313,4,3,320,0,1818,1901,True,127,186,sebsi:1  marzouki:1  
15,4,1,49,6,570,300,600,1,299,300,600,0,0,297,2,1,300,0,1800,1850,True,107,190,sebsi:1  marzouki:1  
15,4,1,49,5,570,352,596,2,242,352,596,0,0,350,2,0,352,0,1805,1900,True,130,220,sebsi:1  marzouki:1  
15,4,1,49,4,570,409,596,0,187,409,596,0,0,407,0,2,409,0,1815,1911,True,190,217,sebsi:1  marzouki:1  
15,4,1,49,2,570,371,595,2,222,371,595,0,0,258,9,4,371,0,1835,,True,216,142,sebsi:1  marzouki:1  
15,4,1,49,1,570,434,600,4,163,433,600,0,0,421,8,4,433,0,1810,1900,True,277,144,sebsi:1  marzouki:1  
15,4,1,48,6,532,223,600,0,377,223,600,0,0,219,3,1,223,0,1800,1900,True,105,114,sebsi:1  marzouki:1  
15,4,1,48,5,533,267,600,0,333,267,600,0,0,262,3,2,267,0,1817,1857,True,103,159,sebsi:1  marzouki:1  
15,4,1,48,4,533,312,600,0,288,312,600,0,0,307,2,3,312,0,1808,1855,True,138,169,sebsi:1  marzouki:1  
15,4,1,48,3,533,358,600,0,242,358,600,0,0,355,2,1,358,0,1840,1930,True,183,172,sebsi:1  marzouki:1  
15,4,1,48,2,533,381,600,0,219,381,600,0,0,361,15,5,381,0,1810,1925,True,215,146,sebsi:1  marzouki:1  
15,4,1,48,1,533,374,600,0,226,374,600,0,0,362,12,0,374,0,1810,1930,True,239,123,sebsi:1  marzouki:1  
15,6,4,97,1,133,51,200,0,149,51,200,0,0,48,3,0,51,0,1808,1830,False,32,16,sebsi:1  marzouki:1  
15,6,3,96,1,536,203,600,0,397,203,600,0,0,196,1,6,203,0,1805,1830,True,142,54,sebsi:1  marzouki:1  
15,6,2,94,1,301,115,400,0,285,115,400,0,0,115,0,0,115,0,1800,1820,True,104,11,sebsi:1  marzouki:1  
15,12,13,277,1,276,125,300,0,175,125,300,0,0,124,1,0,125,0,1515,1540,False,82,42,sebsi:  marzouki:  
15,12,13,276,2,431,119,500,0,381,119,500,0,0,113,4,2,119,0,1820,1900,True,26,87,sebsi:  marzouki:  
15,12,13,276,1,431,228,496,0,268,228,496,0,0,219,9,0,228,0,1815,1900,True,52,167,sebsi:  marzouki:  
15,12,12,275,1,550,287,600,0,313,287,600,0,0,285,1,1,287,0,1530,1555,True,27,258,sebsi:  marzouki:  
15,12,11,274,1,228,129,300,0,171,129,300,0,0,128,1,0,129,0,,1825,True,19,109,sebsi:  marzouki:  
15,12,11,273,2,434,178,500,0,322,178,500,0,0,175,2,1,178,0,1810,1900,True,38,137,sebsi:  marzouki:  
15,12,11,273,1,434,263,500,0,237,263,500,0,0,258,2,3,263,0,1830,1915,True,92,166,sebsi:  marzouki:  
15,12,10,272,1,182,87,200,0,113,87,200,0,0,86,1,0,87,0,1805,1830,True,55,31,sebsi:  marzouki:  
15,12,10,271,1,42,16,100,0,84,16,100,0,0,16,0,0,16,0,1505,1515,True,9,7,sebsi:  marzouki:  
15,12,10,270,1,384,187,500,0,313,187,500,0,0,182,5,0,187,0,1812,1845,True,50,132,sebsi:  marzouki:  
15,12,9,269,1,143,87,200,0,113,87,200,0,0,87,0,0,87,0,1810,1830,False,57,30,sebsi:1  marzouki:1  
15,12,9,268,1,373,161,400,0,239,161,400,0,0,153,8,0,161,0,1800,1840,False,101,52,sebsi:1  marzouki:1  
15,12,9,267,1,93,43,96,0,53,43,96,0,0,42,1,0,43,0,1810,1830,True,21,21,sebsi:1  marzouki:1  
15,12,8,266,1,394,149,500,0,351,149,500,0,0,147,2,0,149,0,1530,1600,True,62,85,sebsi:1  marzouki:1  
15,12,8,265,2,327,107,396,0,289,107,396,0,0,103,4,0,107,0,1515,1545,True,33,70,sebsi:1  marzouki:1  
15,12,8,265,1,328,193,400,0,207,193,400,0,0,178,15,0,193,0,1510,1540,True,79,99,sebsi:1  marzouki:1  
15,12,7,264,1,124,54,200,0,146,54,200,0,0,52,2,0,54,0,1810,1824,True,4,48,sebsi:  marzouki:  
15,12,5,258,1,504,237,600,0,363,237,600,0,0,226,10,1,237,0,1800,1900,False,65,161,sebsi:  marzouki:  
15,12,5,257,1,599,254,700,0,446,254,700,0,0,240,14,0,254,0,1805,1840,True,109,131,sebsi:  marzouki:  
15,12,4,256,2,371,146,395,0,249,146,395,0,0,143,2,1,146,0,1815,1855,True,84,59,sebsi:  marzouki:  
15,12,4,255,2,379,224,395,0,171,224,395,0,0,221,3,0,224,0,1815,1905,True,67,154,sebsi:  marzouki:  
15,12,4,255,1,380,263,400,0,137,263,400,0,0,258,4,1,263,0,1800,1856,True,108,150,sebsi:  marzouki:  
15,12,4,254,1,349,130,396,0,266,130,396,0,0,126,1,3,130,0,1805,1835,True,68,58,sebsi:  marzouki:  
15,12,3,253,1,225,157,300,0,143,157,300,0,0,155,0,2,157,0,1820,1905,True,57,98,sebsi:  marzouki:  
15,12,3,252,2,542,272,600,0,328,272,600,0,0,269,3,0,272,0,1805,1920,True,41,228,sebsi:  marzouki:  
15,12,3,252,1,542,376,600,0,224,376,600,0,0,369,7,0,376,0,1815,1900,True,99,270,sebsi:  marzouki:  
15,12,3,251,1,585,302,700,0,398,302,700,0,0,289,8,5,302,0,1815,1854,True,107,182,sebsi:  marzouki:  
15,12,2,250,1,452,232,500,0,268,232,500,0,0,227,3,2,232,0,1815,1840,True,56,171,sebsi:  marzouki:  
15,12,2,249,1,160,82,200,0,118,82,200,0,0,82,0,0,82,0,1805,1815,True,26,56,sebsi:  marzouki:  
15,12,2,248,1,235,106,300,1,193,106,300,0,0,103,3,0,106,0,1817,1840,True,48,55,sebsi:1  marzouki:1  
15,12,2,247,2,393,290,500,0,210,290,500,0,0,285,3,2,290,0,1814,1845,False,24,261,sebsi:  marzouki:  
15,12,2,247,1,393,242,500,0,258,242,500,0,0,234,7,1,242,0,1800,1900,True,54,180,sebsi:  marzouki:  
15,12,1,246,1,469,252,503,0,251,252,503,0,0,245,5,2,252,0,1809,1850,True,50,195,sebsi:  marzouki:  
15,12,1,245,2,572,266,700,0,434,266,700,0,0,261,3,2,266,0,1805,1858,True,35,226,sebsi:  marzouki:  
15,12,1,245,1,572,370,700,0,330,370,700,0,0,356,9,5,370,0,1810,1905,True,88,268,sebsi:  marzouki:  
15,12,1,244,6,536,235,600,0,365,235,600,0,0,224,8,3,235,0,1800,1900,True,41,183,sebsi:  marzouki:  
15,12,1,244,5,537,232,600,0,368,232,600,0,0,227,4,1,232,0,1805,1845,True,40,187,sebsi:  marzouki:  
15,12,1,244,4,537,298,604,2,304,298,604,0,0,293,4,1,298,0,1830,1920,False,64,229,sebsi:  marzouki:  
15,12,1,244,3,537,357,604,0,247,357,604,0,0,350,4,3,357,0,1800,1900,True,97,253,sebsi:  marzouki:  
15,12,1,244,2,537,339,596,0,257,339,596,0,0,329,9,1,339,0,,1900,True,98,231,sebsi:  marzouki:  
15,12,1,244,1,537,354,600,0,246,354,600,0,0,335,18,1,354,0,1800,1900,True,164,171,sebsi:  marzouki:  
15,11,12,243,1,98,40,200,0,160,40,200,0,0,39,1,0,40,0,1500,1530,True,4,35,sebsi:  marzouki:  
15,11,12,242,1,156,80,200,0,120,80,200,0,0,71,9,0,80,0,1510,1536,True,5,66,sebsi:  marzouki:  
15,11,11,241,2,375,135,400,0,265,135,400,0,0,132,2,1,135,0,1800,1838,True,45,87,sebsi:1  marzouki:1  
15,11,11,241,1,376,219,400,0,181,219,400,0,0,212,6,1,219,0,1815,1900,True,83,129,sebsi:1  marzouki:1  
15,11,11,240,4,504,165,600,0,435,165,600,0,0,162,0,3,165,0,1809,1900,True,49,113,sebsi:1  marzouki:1  
15,11,11,240,2,505,302,600,0,298,302,600,0,0,297,3,2,302,0,1830,1900,True,102,195,sebsi:1  marzouki:1  
15,11,11,240,1,505,316,600,0,284,316,600,0,0,297,15,4,316,0,1810,1903,True,143,154,sebsi:1  marzouki:1  
15,11,10,239,1,193,115,300,0,185,115,300,0,0,113,2,0,115,0,1520,1535,True,20,93,sebsi:1  marzouki:1  
15,11,10,238,1,265,91,300,0,209,91,300,0,0,89,2,0,91,0,1805,1820,False,24,65,sebsi:1  marzouki:1  
15,11,9,237,1,99,40,200,0,160,40,200,0,0,39,1,0,40,0,1810,1830,False,26,13,sebsi:1  marzouki:1  
15,11,9,236,1,62,27,100,0,73,27,100,0,0,26,1,0,27,0,1805,1815,True,14,12,sebsi:1  marzouki:1  
15,11,9,235,1,77,34,100,0,66,34,100,0,0,34,0,0,34,0,,1815,False,16,18,sebsi:1  marzouki:1  
15,11,8,234,1,273,161,300,1,138,161,300,0,0,159,2,0,161,0,1810,1830,True,53,106,sebsi:1  marzouki:1  
15,11,8,233,1,308,113,396,0,283,113,396,0,0,113,0,0,113,0,1530,1600,True,46,67,sebsi:1  marzouki:1  
15,11,8,232,1,256,152,300,0,148,152,300,0,0,151,1,0,152,0,1800,1831,True,25,126,sebsi:1  marzouki:1  
15,11,7,231,1,191,134,300,0,166,134,300,0,0,134,0,0,134,0,1815,1845,True,7,127,sebsi:1  marzouki:1  
15,11,7,230,1,387,135,500,0,365,135,500,0,0,134,1,0,135,0,1810,1845,False,37,97,sebsi:1  marzouki:1  
15,11,7,229,1,256,76,300,0,224,76,300,0,0,72,4,0,76,0,1810,1825,True,44,28,sebsi:1  marzouki:1  
15,11,7,228,1,458,174,496,0,322,174,496,0,0,169,4,1,174,0,1810,1850,True,81,88,sebsi:1  marzouki:1  
15,11,6,227,1,184,39,200,0,161,39,200,0,0,38,1,0,39,0,1805,1831,True,20,18,sebsi:1  marzouki:1  
15,11,6,226,1,85,25,100,0,75,25,100,0,0,24,1,0,25,0,1830,1900,True,14,10,sebsi:1  marzouki:1  
15,11,6,225,1,60,14,100,0,86,14,100,0,0,14,0,0,14,0,1800,1820,True,7,7,sebsi:1  marzouki:1  
15,11,5,224,1,87,28,100,0,72,28,100,0,0,28,0,0,28,0,1803,1815,True,15,13,sebsi:1  marzouki:1  
15,11,5,223,1,77,37,100,0,63,37,100,0,0,36,1,0,37,0,1805,1818,False,20,16,sebsi:1  marzouki:1  
15,11,3,218,3,403,121,500,0,379,121,500,0,0,118,1,2,121,0,1805,1855,True,31,87,sebsi:1  marzouki:1  
15,11,3,218,2,403,171,500,0,329,171,500,0,0,166,4,1,171,0,1810,1840,True,60,106,sebsi:1  marzouki:1  
15,11,3,218,1,403,242,500,0,258,242,500,0,0,234,8,0,242,0,1811,1857,True,106,128,sebsi:1  marzouki:1  
15,11,3,217,3,430,213,500,0,287,213,500,0,0,205,5,3,213,0,1800,1855,True,56,149,sebsi:1  marzouki:1  
15,11,3,217,2,430,279,500,0,221,279,500,0,0,274,5,0,279,0,1800,1917,True,124,150,sebsi:1  marzouki:1  
15,11,3,217,1,430,293,500,0,207,293,500,0,0,284,8,1,293,0,1805,1854,True,143,141,sebsi:1  marzouki:1  
15,11,3,216,3,557,275,600,0,325,275,600,0,0,271,2,2,275,0,1810,1830,True,76,195,sebsi:1  marzouki:1  
15,11,3,216,2,557,350,600,0,250,350,600,0,0,342,6,2,350,0,1815,1844,True,133,209,sebsi:1  marzouki:1  
15,11,3,216,1,557,382,605,0,223,382,605,0,0,374,6,2,382,0,1818,1914,True,183,191,sebsi:1  marzouki:1  
15,11,3,215,3,514,249,600,0,351,249,600,0,0,242,4,3,249,0,1815,1843,True,65,177,sebsi:1  marzouki:1  
15,11,3,215,2,514,307,600,1,292,307,600,0,0,300,6,1,307,0,1803,1904,True,107,193,sebsi:1  marzouki:1  
15,11,3,215,1,514,345,600,1,254,345,600,0,0,341,2,2,345,0,1815,1900,True,153,188,sebsi:1  marzouki:1  
15,11,2,214,3,488,165,601,0,436,165,601,0,0,158,5,2,165,0,1800,1840,True,49,109,sebsi:1  marzouki:1  
15,11,2,214,2,488,224,600,0,376,224,600,0,0,219,4,1,224,0,1805,1842,True,90,129,sebsi:1  marzouki:1  
15,11,2,214,1,488,303,600,0,297,303,600,0,0,295,6,2,303,0,1815,1930,False,164,131,sebsi:1  marzouki:1  
15,11,1,213,3,485,263,600,0,337,263,600,0,0,256,5,2,263,0,1800,1900,True,114,142,sebsi:1  marzouki:1  
15,11,1,213,2,485,339,596,0,257,339,596,0,0,334,4,1,339,0,1803,1858,True,165,169,sebsi:1  marzouki:1  
15,11,1,213,1,485,298,600,0,302,298,600,0,0,286,8,4,298,0,1900,1900,True,173,113,sebsi:1  marzouki:1  
15,11,1,211,3,435,194,500,0,306,194,500,0,0,193,0,1,194,0,1815,1900,False,69,124,sebsi:1  marzouki:1  
15,11,1,211,2,435,257,500,0,243,257,500,0,0,254,3,0,257,0,1815,1900,True,125,129,sebsi:1  marzouki:1  
15,11,1,211,1,435,319,500,1,180,319,500,0,0,310,4,5,319,0,1810,1905,True,174,136,sebsi:1  marzouki:1  
15,1,3,5,2,314,154,400,0,246,154,400,0,0,151,0,3,154,0,1800,1830,False,42,109,sebsi:1  marzouki:1  
15,1,3,5,1,314,199,400,0,201,199,400,0,0,193,4,2,199,0,1800,,True,76,117,sebsi:1  marzouki:1  
15,1,2,4,4,493,231,600,0,369,231,600,0,0,228,1,2,231,0,1810,1900,True,61,167,sebsi:1  marzouki:1  
15,1,2,4,3,495,278,600,1,321,278,600,0,0,273,5,0,278,0,1800,1900,True,62,211,sebsi:1  marzouki:1  
15,1,2,4,2,495,330,600,1,270,330,601,1,0,324,6,0,330,0,1815,1900,True,111,213,sebsi:1  marzouki:1  
15,1,2,4,1,495,336,600,0,264,336,600,0,0,307,25,4,336,0,,1902,True,116,191,sebsi:1  marzouki:1  
15,1,2,3,6,542,238,600,0,362,238,600,0,0,236,2,0,238,0,1806,1850,True,73,163,sebsi:1  marzouki:1  
15,1,2,3,5,545,233,599,0,366,233,599,0,0,222,8,3,233,0,1805,1915,True,78,144,sebsi:1  marzouki:1  
15,1,2,3,4,545,295,600,0,305,295,600,0,0,288,5,2,295,0,1805,1845,True,111,177,sebsi:1  marzouki:1  
15,1,2,3,3,545,335,600,0,265,335,600,0,0,327,7,1,335,0,1800,1840,True,138,189,sebsi:1  marzouki:1  
15,1,2,3,1,545,351,600,0,249,351,600,0,0,346,5,0,351,0,1810,1850,True,195,151,sebsi:1  marzouki:1  
15,1,1,2,5,492,225,600,0,375,225,600,0,0,221,4,0,225,0,1820,1928,True,66,155,sebsi:1  marzouki:1  
15,1,1,2,4,496,252,600,0,348,252,600,0,0,248,1,3,252,0,1800,1920,True,72,176,sebsi:1  marzouki:1  
15,1,1,2,3,496,308,600,1,291,308,600,0,0,296,12,0,308,0,1821,1921,True,121,175,sebsi:1  marzouki:1  
15,1,1,2,2,496,339,600,1,260,339,600,0,0,332,7,0,339,0,1800,,False,135,197,sebsi:1  marzouki:1  
15,1,1,2,1,496,314,600,0,286,314,600,0,0,304,10,0,314,0,1812,1915,True,155,149,sebsi:1  marzouki:1  
15,1,1,1,7,529,241,596,1,354,241,596,0,0,238,2,1,241,0,1800,1846,True,61,177,sebsi:1  marzouki:1  
15,1,1,1,6,531,240,600,0,360,240,600,0,0,238,2,0,240,0,,1840,True,66,172,sebsi:1  marzouki:1  
15,1,1,1,5,531,267,600,2,331,267,600,0,0,264,2,1,267,0,1815,1900,False,74,190,sebsi:1  marzouki:1  
15,1,1,1,4,531,311,602,1,290,311,602,0,0,307,3,1,311,0,1810,1845,True,103,204,sebsi:1  marzouki:1  
15,1,1,1,3,531,373,600,0,227,373,600,0,0,369,3,1,373,0,1812,1930,False,149,220,sebsi:1  marzouki:1  
15,1,1,1,2,531,341,600,0,259,341,600,0,0,334,6,1,341,0,1810,1907,False,157,177,sebsi:1  marzouki:1  
15,2,6,24,1,390,119,500,0,381,119,500,0,0,113,6,0,119,0,1505,1546,True,46,67,sebsi:1  marzouki:1  
15,2,5,23,1,261,96,300,0,204,96,300,0,0,95,1,0,96,0,1800,1820,True,52,43,sebsi:1  marzouki:1  
15,2,5,22,1,171,68,200,0,132,68,200,0,0,66,2,0,68,0,1805,1823,True,27,39,sebsi:1  marzouki:1  
15,2,5,21,1,532,190,600,0,410,190,600,0,0,187,2,1,190,0,1810,1830,True,82,105,sebsi:1  marzouki:1  
15,2,5,20,1,205,65,300,0,235,65,300,0,0,57,5,3,65,0,1508,1530,True,30,27,sebsi:1  marzouki:1  
15,2,4,19,1,367,148,402,1,253,148,402,0,0,135,9,4,148,0,1800,1849,True,85,50,sebsi:1  marzouki:1  
15,2,4,18,1,257,100,300,0,200,100,300,0,0,98,2,0,100,0,1800,1825,True,73,25,sebsi:1  marzouki:1  
15,2,3,17,1,225,116,300,0,184,116,300,0,0,115,1,0,116,0,1804,1833,False,31,84,sebsi:1  marzouki:1  
15,2,3,16,1,381,156,500,1,343,156,500,0,0,153,2,1,156,0,1811,1833,True,47,106,sebsi:1  marzouki:1  
15,2,3,15,1,299,79,400,0,321,79,400,0,0,72,6,1,79,0,1800,1825,False,49,23,sebsi:1  marzouki:1  
15,2,2,14,1,567,248,600,0,352,248,600,0,0,242,5,1,248,0,1807,1845,False,108,134,sebsi:1  marzouki:1  
15,2,2,13,1,237,93,300,0,207,93,300,0,0,92,0,1,93,0,1805,1820,True,32,60,sebsi:1  marzouki:1  
15,2,2,12,1,219,89,300,0,211,89,300,0,0,89,0,0,89,0,1805,,False,37,52,sebsi:1  marzouki:1  
15,2,1,6,2,417,208,500,0,292,208,500,0,0,197,8,3,208,0,1806,1846,True,110,87,sebsi:1  marzouki:1  
15,2,1,6,1,417,250,500,0,250,250,500,0,0,244,6,0,250,0,1805,1900,True,171,73,sebsi:1  marzouki:1  
