circonscriptionId,delegationId,subDelegationId,centerID,stationId,registeredVoters,aSigningVoters,bDeliveredBallots,cSpoiledBallots,dLeftBallots,fExtractedBallots,gEplusF,hBminusG,iAminusF,jListVotes,kCancelledVotes,lBlankVotes,mJplusKplusL,nFminusM,countingStart,countingEnd,tampon,sebsi,marzouki,observers
19,3,7,36,1,441,279,500,0,221,279,500,0,0,276,1,2,279,0,18.05,18.40,True,84,192,sebsi:1  marzouki:1  
19,3,7,35,3,496,261,588,0,327,261,588,0,0,257,3,1,261,0,18.00,18.40,True,24,233,sebsi:1  marzouki:1  
19,3,7,35,2,498,331,600,0,269,331,600,0,0,329,1,1,331,0,18.15,18.46,True,27,302,sebsi:1  marzouki:1  
19,3,7,35,1,498,362,601,0,239,362,601,0,0,347,7,8,362,0,18.10,19.00,True,50,297,sebsi:1  marzouki:1  
19,3,6,34,1,500,359,601,0,242,359,601,0,0,357,1,1,359,0,18.15,19.15,True,46,311,sebsi:1  marzouki:1  
19,3,6,33,2,453,274,500,0,226,274,500,0,0,270,2,2,274,0,18.15,19.00,True,45,225,sebsi:1  marzouki:1  
19,3,6,33,1,453,345,500,0,155,345,500,0,0,336,5,4,345,0,18.15,19.10,True,98,238,sebsi:1  marzouki:1  
19,3,5,32,2,457,310,500,0,190,310,500,0,0,304,3,3,310,0,18.00,18.55,True,62,242,sebsi:1  marzouki:1  
19,3,5,32,1,458,362,500,0,138,362,500,0,0,350,6,6,362,0,18.30,18.55,True,117,233,sebsi:1  marzouki:1  
19,3,5,31,2,560,356,600,2,242,356,600,0,0,350,3,3,356,0,18.26,19.20,True,68,282,sebsi:1  marzouki:1  
19,3,4,30,3,400,255,500,0,245,255,500,0,0,255,0,0,255,0,18.15,19.00,True,30,225,sebsi:1  marzouki:1  
19,3,4,30,2,402,287,500,0,213,287,500,0,0,285,2,0,287,0,18.00,19.30,True,37,248,sebsi:1  marzouki:1  
19,3,4,30,1,402,285,500,1,214,285,500,0,0,277,7,1,285,0,18.05,19.00,True,59,218,sebsi:1  marzouki:1  
19,3,3,29,2,386,232,500,0,268,232,500,0,0,228,2,2,232,0,18.10,18.45,True,26,202,sebsi:1  marzouki:1  
19,3,3,29,1,387,272,500,0,228,272,500,0,0,262,9,1,272,0,18.15,18.55,True,40,222,sebsi:1  marzouki:1  
19,3,3,28,2,512,284,599,0,315,284,599,0,0,280,2,2,284,0,18.15,18.55,True,24,256,sebsi:1  marzouki:1  
19,3,3,28,1,512,371,600,3,226,371,600,0,0,360,5,6,371,0,18.10,19.25,True,92,268,sebsi:1  marzouki:1  
19,3,3,27,2,542,310,600,0,289,310,599,0,0,306,2,2,310,0,18.29,19.06,True,37,269,sebsi:1  marzouki:1  
19,3,3,27,1,543,402,600,0,198,402,600,0,0,390,6,6,402,0,18.15,19.00,True,84,306,sebsi:1  marzouki:1  
19,3,2,26,1,334,186,400,0,214,186,400,0,0,184,2,0,186,0,18.00,18.37,True,20,164,sebsi:1  marzouki:1  
19,3,2,25,2,393,174,500,0,326,174,500,0,0,168,3,3,174,0,18.20,19.10,True,11,157,sebsi:1  marzouki:1  
19,3,2,25,1,393,257,500,1,242,257,500,0,0,250,5,2,257,0,18.15,18.48,True,24,226,sebsi:1  marzouki:1  
19,3,2,24,2,435,248,500,0,252,248,500,0,0,247,0,1,248,0,18.20,18.50,True,17,230,sebsi:1  marzouki:1  
19,3,2,24,1,435,290,500,2,208,290,500,0,0,285,2,3,290,0,06.10,07.05,True,26,259,sebsi:1  marzouki:1  
19,3,2,23,3,409,161,500,0,339,161,500,0,0,156,2,3,161,0,18.20,18.55,True,21,135,sebsi:1  marzouki:1  
19,3,2,23,2,410,242,500,0,258,242,500,0,0,238,1,3,242,0,18.12,19.30,True,30,208,sebsi:1  marzouki:1  
19,3,2,23,1,410,299,500,0,201,299,500,0,0,291,3,5,299,0,18.15,19.15,True,50,241,sebsi:1  marzouki:1  
19,3,1,22,2,542,319,600,0,281,319,600,0,0,303,14,2,319,0,18.27,19.49,True,58,245,sebsi:1  marzouki:1  
19,3,1,22,1,543,409,600,0,191,409,600,0,0,401,3,5,409,0,18.20,19.07,True,139,262,sebsi:1  marzouki:1  
19,3,1,21,3,408,238,500,0,262,238,500,0,0,235,2,1,238,0,18.15,19.00,True,12,223,sebsi:1  marzouki:1  
19,3,1,21,2,409,310,500,1,189,310,500,0,0,302,6,2,310,0,18.15,19.13,True,33,269,sebsi:1  marzouki:1  
19,3,1,21,1,409,310,500,2,188,310,500,0,0,307,2,1,310,0,18.30,19.00,True,53,254,sebsi:1  marzouki:1  
19,3,1,20,4,494,260,600,0,340,260,600,0,0,254,5,1,260,0,18.00,18.53,True,40,214,sebsi:1  marzouki:1  
19,3,1,20,3,496,298,601,0,303,298,601,0,0,292,3,3,298,0,18.00,19.18,True,55,237,sebsi:1  marzouki:1  
19,3,1,20,2,496,382,599,2,215,382,599,0,0,377,1,4,382,0,,19.00,True,115,262,sebsi:1  marzouki:1  
19,3,1,20,1,496,328,599,0,271,328,599,0,0,311,14,3,328,0,18.00,19.20,True,119,192,sebsi:1  marzouki:1  
19,5,7,65,3,495,303,600,1,296,303,600,0,0,302,0,1,303,0,18.12,19.05,True,42,260,sebsi:1  marzouki:1  
19,5,7,65,2,495,368,599,0,231,368,599,0,0,365,3,0,368,0,18.20,19.20,True,54,311,sebsi:1  marzouki:1  
19,5,7,65,1,495,367,600,0,233,367,600,0,0,352,11,4,367,0,18.15,19.07,True,62,290,sebsi:1  marzouki:1  
19,5,6,64,3,503,308,600,1,291,308,600,0,0,305,2,1,308,0,18.10,19.21,True,13,292,sebsi:0  marzouki:1  
19,5,6,64,2,503,365,600,0,235,365,600,0,0,363,2,0,365,0,18.20,19.05,True,25,338,sebsi:1  marzouki:1  
19,5,6,64,1,503,378,600,1,221,378,600,0,0,365,4,9,378,0,18.05,19.10,True,66,299,sebsi:1  marzouki:1  
19,5,5,63,3,482,323,600,0,277,323,600,0,0,313,1,9,323,0,18.05,18.56,True,76,237,sebsi:1  marzouki:1  
19,5,5,63,2,484,366,600,1,233,366,600,0,0,360,1,5,366,0,18.00,19.03,True,83,277,sebsi:1  marzouki:1  
19,5,5,63,1,484,404,600,0,196,404,600,0,0,396,2,6,404,0,18.30,19.07,True,124,272,sebsi:1  marzouki:1  
19,5,4,62,3,549,430,600,0,170,430,600,0,0,428,2,0,430,0,1809,1930,True,6,422,sebsi:0  marzouki:1  
19,5,4,62,2,550,454,600,0,146,454,600,0,0,447,5,2,454,0,1820,1940,True,12,435,sebsi:0  marzouki:2  
19,5,4,62,1,550,443,600,2,155,443,600,0,0,438,5,0,443,0,1815,1915,True,28,410,sebsi:0  marzouki:1  
19,5,3,61,4,511,347,600,0,253,347,600,0,0,344,3,0,347,0,1820,1918,True,5,339,sebsi:0  marzouki:1  
19,5,3,61,3,514,391,600,0,209,391,600,0,0,391,0,0,391,0,1805,1935,True,16,375,sebsi:0  marzouki:1  
19,5,3,61,2,514,430,600,1,169,430,600,0,0,427,1,2,430,0,18.22,19.20,True,21,406,marzouki:1  :1  
19,5,3,61,1,514,374,601,0,227,374,601,0,0,365,7,2,374,0,18.10,19.00,True,33,332,sebsi:1  marzouki:1  
19,5,2,60,1,581,432,700,0,268,432,700,0,0,426,3,3,432,0,18.30,19.45,True,75,351,sebsi:1  marzouki:2  
19,5,2,59,3,468,347,500,0,153,347,500,0,0,345,1,1,347,0,18.40,19.30,True,42,303,sebsi:0  marzouki:1  
19,5,2,59,2,470,378,500,0,122,378,600,0,0,373,2,3,378,0,18.30,19.10,True,53,320,sebsi:1  marzouki:1  
19,5,2,59,1,470,344,500,0,156,344,500,0,0,343,1,0,344,0,18.17,19.04,True,80,263,sebsi:1  marzouki:1  
19,5,1,58,1,256,243,300,1,56,243,300,0,0,242,1,0,243,0,1805,1845,True,13,229,sebsi:1  marzouki:1  
19,5,1,57,1,276,211,300,0,89,211,300,0,0,208,2,1,211,0,18.10,18.36,True,9,199,sebsi:1  marzouki:1  
19,5,1,56,1,502,343,600,0,257,343,600,0,0,342,1,0,343,0,18.18,19.14,True,50,292,sebsi:0  marzouki:1  
19,5,1,55,2,303,162,400,0,238,162,400,0,0,160,2,0,162,0,18.00,19.00,True,17,143,sebsi:1  marzouki:0  
19,5,1,55,1,304,198,400,0,202,198,400,0,0,197,0,1,198,0,18.07,18.30,True,43,154,sebsi:0  marzouki:1  
19,5,1,54,2,420,253,496,0,243,253,496,0,0,250,2,1,253,0,18.00,18.45,True,8,242,sebsi:0  marzouki:1  
19,5,1,54,1,421,308,500,1,191,308,500,0,0,305,2,1,308,0,18.00,18.50,True,42,263,sebsi:0  marzouki:1  
19,5,1,53,2,526,392,600,0,208,392,600,0,0,389,2,1,392,0,18.15,19.20,True,6,383,sebsi:0  marzouki:1  
19,5,1,53,1,527,449,600,2,150,449,601,0,0,446,2,1,449,0,18.15,20.00,True,12,434,sebsi:1  marzouki:1  
19,5,1,52,2,384,288,500,0,212,288,500,0,0,287,0,1,288,0,18.05,18.42,True,23,264,sebsi:1  marzouki:1  
19,5,1,52,1,385,322,500,1,177,322,500,0,0,317,4,1,322,0,18.10,19.00,True,45,272,sebsi:1  marzouki:1  
19,5,1,51,4,590,332,700,0,368,332,700,0,0,326,3,3,332,0,18.10,18.45,True,76,250,sebsi:1  marzouki:1  
19,5,1,51,3,592,395,702,0,307,395,702,0,0,391,1,3,395,0,18.12,19.25,True,79,312,sebsi:1  marzouki:1  
19,5,1,51,2,592,463,700,2,235,463,700,0,0,441,16,6,463,0,18.15,19.30,False,106,335,sebsi:1  marzouki:1  
19,5,1,51,1,592,416,700,0,284,416,700,0,0,409,6,1,416,0,18.14,19.26,True,125,284,sebsi:1  marzouki:1  
19,5,1,50,2,413,265,500,0,235,265,500,0,0,262,1,2,265,0,18.00,19.10,True,54,208,sebsi:1  marzouki:1  
19,5,1,50,1,413,315,500,1,184,315,500,0,0,308,6,1,315,0,18.10,19.05,True,91,217,sebsi:1  marzouki:1  
19,6,10,81,3,594,373,700,0,327,373,700,0,0,363,4,6,373,0,18.20,19.00,True,82,281,sebsi:0  marzouki:1  
19,6,10,81,2,596,447,700,0,253,447,700,0,0,440,3,4,447,0,18.30,19.35,True,105,335,sebsi:1  marzouki:1  
19,6,10,81,1,596,464,700,2,234,464,700,0,0,462,1,1,464,0,18.23,19.37,True,163,299,sebsi:1  marzouki:1  
19,6,9,80,2,378,254,400,0,146,254,400,0,0,252,2,0,254,0,18.15,18.50,True,40,212,sebsi:1  marzouki:1  
19,6,9,80,1,378,291,400,0,109,291,400,0,0,286,5,0,291,0,18.15,18.41,True,80,206,sebsi:1  marzouki:1  
19,6,8,79,1,158,115,200,0,85,115,200,0,0,115,0,0,115,0,1800,1823,True,10,105,sebsi:0  marzouki:1  
19,6,8,77,1,157,129,200,0,71,129,200,0,0,128,0,1,129,0,18.10,18.24,True,2,126,sebsi:0  marzouki:1  
19,6,8,76,1,161,124,200,0,76,124,200,0,0,120,2,2,124,0,18.10,18.30,True,9,111,sebsi:1  marzouki:1  
19,6,7,75,2,533,312,600,0,288,312,600,0,0,306,2,4,312,0,18.05,18.52,True,27,279,sebsi:1  marzouki:1  
19,6,7,75,1,533,385,600,1,214,385,600,0,0,373,8,4,385,0,18.10,19.15,True,80,293,sebsi:1  marzouki:1  
19,6,6,74,2,522,322,700,0,378,322,700,0,0,320,2,0,322,0,18.12,,False,29,291,sebsi:1  marzouki:1  
19,6,6,74,1,522,367,700,0,333,367,700,0,0,360,4,3,367,0,18.20,19.05,True,59,301,sebsi:1  marzouki:1  
19,6,5,73,1,568,370,700,0,330,370,700,0,0,361,8,1,370,0,18.30,19.10,True,32,329,sebsi:1  marzouki:1  
19,6,5,72,2,340,230,400,0,170,230,400,0,0,230,0,0,230,0,18.15,18.35,True,23,207,sebsi:1  marzouki:1  
19,6,5,72,1,341,276,400,0,124,276,400,0,0,269,7,0,276,0,18.15,19.05,True,31,238,sebsi:1  marzouki:1  
19,6,4,71,3,577,284,700,0,416,284,700,0,0,276,5,3,284,0,18.10,18.45,True,84,192,sebsi:1  marzouki:1  
19,6,4,71,2,577,373,700,0,327,373,700,0,0,365,4,4,373,0,18.15,18.57,True,139,226,sebsi:1  marzouki:1  
19,6,4,71,1,577,383,700,2,316,382,700,0,1,376,0,6,382,0,18.30,19.00,True,163,213,sebsi:1  marzouki:1  
19,6,3,70,3,469,289,500,0,211,289,500,0,0,286,2,1,289,0,18.40,19.00,True,25,261,sebsi:1  marzouki:1  
19,6,3,70,2,469,324,500,2,174,324,500,0,0,321,0,3,324,0,18.15,19.00,True,58,263,sebsi:1  marzouki:1  
19,6,3,70,1,469,333,500,2,165,333,500,0,0,325,3,5,333,0,18.05,19.00,False,75,250,sebsi:1  marzouki:1  
19,6,2,69,2,446,257,500,0,243,257,500,0,0,248,6,3,257,0,18.00,18.45,True,75,173,sebsi:1  marzouki:1  
19,6,1,67,1,409,299,500,1,200,299,500,0,0,297,2,0,299,0,18.00,18.40,True,55,242,sebsi:1  marzouki:1  
19,6,1,66,3,477,274,602,0,328,274,602,0,0,270,2,2,274,0,18.25,19.20,True,59,211,sebsi:1  marzouki:1  
19,6,1,66,2,479,365,600,1,235,364,600,0,1,361,2,1,364,0,18.15,19.18,True,80,281,sebsi:1  marzouki:1  
19,6,1,66,1,479,384,600,0,216,384,600,0,0,373,7,4,384,0,18.07,19.00,True,103,270,sebsi:1  marzouki:1  
19,4,6,49,1,289,224,400,0,176,224,400,0,0,224,0,0,224,0,18.15,18.35,True,25,199,sebsi:1  marzouki:1  
19,4,6,48,2,510,326,602,0,276,326,602,0,0,325,0,1,326,0,18.20,19.00,True,13,312,sebsi:1  marzouki:1  
19,4,6,48,1,511,369,600,0,231,369,600,0,0,369,0,0,369,0,18.05,18.50,True,41,328,sebsi:0  marzouki:1  
19,4,5,47,1,377,215,401,0,186,215,401,0,0,215,0,0,215,0,18.00,18.26,True,40,175,sebsi:1  marzouki:1  
19,4,5,46,1,135,94,200,0,106,94,200,0,0,93,1,0,94,0,18.00,,True,24,69,sebsi:0  marzouki:1  
19,4,5,45,1,368,221,400,0,179,221,400,0,0,218,0,3,221,0,18.10,18.36,True,52,166,sebsi:1  marzouki:1  
19,4,5,44,2,407,130,500,0,370,130,500,0,0,128,1,1,130,0,18.03,18.20,True,29,99,sebsi:1  marzouki:1  
19,4,5,44,1,407,238,500,0,262,238,500,0,0,232,5,1,238,0,18.05,18.55,True,129,103,sebsi:1  marzouki:1  
19,4,4,43,3,425,277,500,1,222,277,500,0,0,275,1,1,277,0,1805,1855,True,26,249,sebsi:1  marzouki:1  :  
19,4,4,43,2,427,319,500,1,180,319,500,0,0,319,0,0,319,0,1800,1857,True,23,296,sebsi:1  marzouki:1  :  
19,4,4,43,1,427,326,500,1,172,327,500,0,0,324,3,0,327,0,1830,1855,True,50,274,sebsi:1  marzouki:1  :  
19,4,3,42,2,453,330,503,0,173,330,503,0,0,323,5,2,330,0,1825,2002,True,27,296,sebsi:1  marzouki:1  :  
19,4,3,42,1,454,384,500,2,116,382,500,0,2,376,3,3,382,0,1820,1926,True,52,324,sebsi:1  marzouki:1  :  
19,4,3,41,3,426,250,500,1,249,250,500,0,0,247,1,2,250,0,1825,1920,True,27,220,sebsi:1  marzouki:1  :  
19,4,3,41,2,428,291,500,0,209,291,500,0,0,289,0,2,291,0,1800,1905,True,38,251,sebsi:1  marzouki:1  :  
19,4,2,38,1,324,271,400,0,129,271,400,0,0,269,2,0,271,0,1805,1850,True,20,249,sebsi:1  marzouki:1  :  
19,4,1,37,3,590,354,700,0,346,354,700,0,0,351,3,0,354,0,18.15,18.50,True,31,320,sebsi:1  marzouki:1  
19,4,1,37,2,591,416,699,0,283,416,699,0,0,411,2,3,416,0,18.30,19.30,True,53,358,sebsi:1  marzouki:1  
19,4,1,37,1,591,448,699,1,250,449,699,0,0,434,8,6,448,0,18.30,19.30,True,103,331,sebsi:1  marzouki:1  
19,1,5,9,2,474,311,500,0,189,311,500,0,0,309,1,1,311,0,18.20,19.10,True,20,289,sebsi:1  marzouki:1  
19,1,5,9,1,475,346,498,1,151,346,498,0,0,341,3,2,346,0,18.05,19.15,True,40,301,sebsi:1  marzouki:1  
19,1,4,8,3,481,315,604,1,288,315,604,0,0,310,4,1,315,0,18.15,19.05,True,21,289,sebsi:1  marzouki:1  
19,1,4,8,2,482,355,600,0,245,355,600,0,0,354,0,1,355,0,18.10,19.00,True,23,331,sebsi:1  marzouki:1  
19,1,4,8,1,482,377,598,0,221,377,598,0,0,371,5,1,377,0,18.20,19.16,True,61,310,sebsi:1  marzouki:1  
19,1,3,7,1,101,51,200,0,149,51,200,0,0,49,2,0,51,0,,18.20,True,10,39,sebsi:1  marzouki:1  
19,1,3,6,3,471,288,600,0,312,288,600,0,0,284,4,0,288,0,18.30,19.13,True,19,265,sebsi:0  marzouki:1  
19,1,3,6,2,472,318,600,1,281,318,600,0,0,312,4,2,318,0,18.10,19.00,True,33,279,sebsi:1  marzouki:1  
19,1,3,6,1,472,322,598,0,276,322,598,0,0,314,7,1,322,0,18.00,18.51,True,74,240,sebsi:0  marzouki:1  
19,1,2,5,1,567,368,600,0,232,368,600,0,0,356,7,5,368,0,18.10,19.02,True,167,189,sebsi:1  marzouki:1  
19,1,2,4,2,467,267,500,0,233,267,500,0,0,266,0,1,267,0,1820,1847,True,75,191,sebsi:1  marzouki:1  :  
19,1,2,4,1,468,318,500,0,182,318,500,0,0,311,6,1,318,0,1800,1921,True,106,205,sebsi:1  marzouki:1  :  
19,1,1,3,2,398,295,500,0,206,294,500,0,1,293,0,1,294,0,18.12,18.50,True,13,280,sebsi:0  marzouki:1  
19,1,1,3,1,399,315,500,1,184,315,500,0,0,309,6,0,315,0,18.20,19.12,True,42,267,sebsi:1  marzouki:1  
19,1,1,2,3,559,413,596,1,182,413,596,0,0,410,3,0,413,0,18.10,19.00,True,15,395,sebsi:0  marzouki:1  
19,1,1,2,2,560,479,598,0,119,479,598,0,0,471,8,0,479,0,18.10,19.38,True,25,446,sebsi:0  marzouki:1  
19,1,1,2,1,560,465,602,1,136,465,602,0,0,455,7,3,465,0,18.12,19.05,True,50,405,sebsi:0  marzouki:1  
19,1,1,1,4,518,357,600,0,243,357,600,0,0,354,3,0,357,0,18.07,18.50,True,10,344,sebsi:1  marzouki:1  
19,1,1,1,3,520,375,600,0,225,375,600,0,0,369,5,1,375,0,18.30,,True,23,346,sebsi:1  marzouki:1  
19,1,1,1,2,520,449,599,0,150,449,599,0,0,439,4,6,449,0,,19.00,True,54,385,sebsi:1  marzouki:1  
19,1,1,1,1,520,400,600,0,200,400,600,0,0,393,7,0,400,0,18.08,19.03,True,65,328,sebsi:1  marzouki:1  
19,2,4,19,3,524,408,598,1,189,408,598,0,0,404,4,0,408,0,18.15,19.00,True,27,377,sebsi:1  marzouki:1  
19,2,4,19,2,525,436,600,1,163,436,600,0,0,428,6,2,436,0,18.20,19.02,True,42,386,sebsi:1  marzouki:1  
19,2,4,19,1,525,435,600,1,164,435,600,0,0,421,12,2,435,0,18.15,19.17,True,58,363,sebsi:1  marzouki:1  
19,2,4,18,3,469,365,508,1,142,365,508,0,0,360,5,0,365,0,18.16,19.10,True,7,353,sebsi:1  marzouki:1  
19,2,4,18,2,469,392,501,0,109,392,501,0,0,390,1,1,392,0,18.05,,True,24,366,sebsi:1  marzouki:1  
19,2,4,18,1,469,378,500,0,122,378,500,0,0,375,3,0,378,0,18.15,19.15,True,34,341,sebsi:1  marzouki:1  
19,2,3,17,1,51,25,100,0,75,25,100,0,0,23,2,0,25,0,18.05,18.22,True,6,17,sebsi:0  marzouki:1  
19,2,3,16,5,495,396,600,1,203,396,600,0,0,392,3,1,396,0,18.13,19.10,True,16,376,sebsi:0  marzouki:1  
19,2,3,16,4,496,383,600,1,216,383,600,0,0,382,1,0,383,0,18.10,18.44,True,9,373,sebsi:0  marzouki:1  
19,2,3,16,3,496,412,603,0,191,412,603,0,0,408,2,2,412,0,18.00,18.40,True,21,387,sebsi:1  marzouki:1  
19,2,3,16,2,496,432,601,0,169,432,601,0,0,428,3,1,432,0,18.10,18.45,True,38,390,sebsi:1  marzouki:1  
19,2,3,16,1,496,390,600,0,210,390,600,0,0,383,5,2,390,0,18.05,18.54,True,47,336,sebsi:1  marzouki:1  
19,2,2,15,2,415,356,500,0,144,356,500,0,0,356,0,0,356,0,,19.15,True,3,353,sebsi:0  marzouki:1  
19,2,2,15,1,415,375,500,0,125,375,500,0,0,371,4,0,375,0,18.20,18.35,True,8,363,sebsi:0  marzouki:1  
19,2,2,14,2,453,367,500,0,133,367,500,0,0,365,0,2,367,0,18.00,19.00,True,5,360,sebsi:0  marzouki:2  
19,2,2,13,1,526,463,600,0,137,463,600,0,0,460,2,1,463,0,18.00,19.30,True,21,439,sebsi:0  marzouki:1  
19,2,1,12,2,460,373,500,0,127,373,500,0,0,369,2,2,373,0,18.15,18.39,True,7,362,sebsi:1  marzouki:1  
19,2,1,12,1,461,383,500,0,117,383,500,0,0,379,4,0,383,0,18.10,18.45,True,20,359,sebsi:  marzouki:  
19,2,1,11,4,490,398,600,0,202,398,600,0,0,397,0,1,398,0,18.15,19.00,True,6,391,sebsi:0  marzouki:1  
19,2,1,11,3,492,400,600,0,200,400,600,0,0,399,1,0,400,0,18.05,18.45,True,6,393,sebsi:0  marzouki:1  
19,2,1,11,2,492,422,600,0,178,422,600,0,0,413,5,4,422,0,18.05,18.50,True,24,389,sebsi:1  marzouki:1  
19,2,1,11,1,492,397,598,0,201,397,598,0,0,393,2,2,397,0,18.10,,True,34,359,sebsi:0  marzouki:1  
19,2,1,10,4,548,394,600,1,205,394,600,0,0,390,2,2,394,0,18.19,19.22,True,20,370,sebsi:1  marzouki:1  
19,2,1,10,3,551,443,600,0,158,442,600,0,1,438,4,0,442,0,18.15,18.50,True,15,423,sebsi:1  marzouki:1  
19,2,1,10,2,551,475,605,0,130,475,605,0,0,471,3,1,475,0,18.10,19.18,True,31,440,sebsi:0  marzouki:1  
19,2,1,10,1,551,445,600,0,155,445,600,0,0,440,5,0,445,0,18.15,19.15,True,54,386,sebsi:0  marzouki:1  
