circonscriptionId,delegationId,subDelegationId,centerID,stationId,registeredVoters,aSigningVoters,bDeliveredBallots,cSpoiledBallots,dLeftBallots,fExtractedBallots,gEplusF,hBminusG,iAminusF,jListVotes,kCancelledVotes,lBlankVotes,mJplusKplusL,nFminusM,countingStart,countingEnd,tampon,sebsi,marzouki,observers
23,6,6,168,3,444,193,500,0,307,193,500,0,0,191,1,1,193,0,1809,1850,False,93,98,sebsi:1  marzouki:1  
23,6,4,165,5,563,378,588,0,210,378,588,0,0,366,5,7,378,0,1820,1915,True,90,276,sebsi:1  marzouki:1  
23,6,4,165,4,564,383,591,0,208,383,591,0,0,376,3,4,383,0,0,1905,False,110,266,sebsi:0  marzouki:1  
23,6,4,165,3,564,415,604,1,188,415,604,0,0,410,4,1,415,0,1830,1920,False,125,285,sebsi:1  marzouki:1  
23,6,4,165,2,564,439,600,0,161,439,600,0,0,431,7,1,439,0,1840,2000,True,142,289,sebsi:1  marzouki:1  
23,6,4,165,1,564,428,600,0,172,428,600,0,0,417,6,5,428,0,1830,1955,False,154,263,sebsi:0  marzouki:1  
23,6,4,164,3,417,249,500,0,251,249,500,0,0,240,5,4,249,0,1815,1859,False,97,143,sebsi:0  marzouki:1  
23,6,4,164,2,418,281,500,0,219,281,500,0,0,277,1,3,281,0,1810,1830,True,113,164,sebsi:1  marzouki:1  
23,6,4,164,1,418,303,500,1,196,303,500,0,0,290,8,5,303,0,1810,1840,True,132,158,sebsi:0  marzouki:1  
23,6,4,163,6,581,421,701,0,280,421,701,0,0,416,3,2,421,0,1830,1920,True,102,314,sebsi:1  marzouki:1  
23,6,4,163,5,581,420,700,0,280,420,700,0,0,413,5,2,420,0,1830,1940,False,120,293,sebsi:0  marzouki:1  
23,6,4,163,4,581,413,699,1,285,413,699,0,0,408,4,1,413,0,1830,1930,False,124,284,sebsi:0  marzouki:1  
23,6,4,163,3,581,444,700,2,254,444,700,0,0,439,2,3,444,0,1900,1920,False,133,306,sebsi:1  marzouki:1  
23,6,4,163,2,581,449,701,0,252,449,701,0,0,443,4,2,449,0,1830,1920,False,138,305,sebsi:1  marzouki:1  
23,6,4,163,1,581,446,700,0,254,446,700,0,0,441,3,2,446,0,1830,1930,False,192,249,sebsi:1  marzouki:1  
23,6,4,162,7,581,429,699,0,270,429,699,0,0,419,5,5,429,0,1835,1928,False,108,311,sebsi:0  marzouki:1  
23,6,4,162,6,586,400,700,0,299,400,699,0,0,394,4,2,400,0,1830,1930,False,132,262,sebsi:1  marzouki:1  
23,6,4,162,5,586,425,700,1,274,425,700,0,0,424,0,1,425,0,,1900,True,159,265,sebsi:1  marzouki:1  
23,6,4,162,4,586,491,700,0,209,491,700,0,0,478,7,6,491,0,1830,1935,False,150,328,sebsi:1  marzouki:1  
23,6,4,162,3,586,468,701,0,233,468,701,0,0,460,5,3,468,0,1820,1925,True,177,283,sebsi:1  marzouki:1  
23,6,4,162,2,586,471,701,2,228,471,701,0,0,460,7,4,471,0,1830,2005,True,169,291,sebsi:0  marzouki:1  
23,6,4,162,1,586,472,700,0,228,472,700,0,0,459,10,3,472,0,1800,1915,True,215,244,sebsi:0  marzouki:1  
23,6,4,161,7,573,430,700,0,270,430,700,0,0,418,7,5,430,0,1820,1945,False,159,259,sebsi:1  marzouki:1  
23,6,4,161,6,574,419,700,0,281,419,700,0,0,410,3,6,419,0,1820,2000,True,171,239,sebsi:1  marzouki:1  
23,6,4,161,5,574,421,700,0,279,421,700,0,0,411,5,5,421,0,1820,1915,False,163,248,sebsi:0  marzouki:1  
23,6,4,161,4,574,456,700,0,244,456,700,0,0,447,3,6,456,0,1810,1910,False,181,266,sebsi:1  marzouki:1  
23,6,4,161,3,574,474,700,0,226,474,700,0,0,467,3,4,474,0,1830,1900,False,194,273,sebsi:1  marzouki:1  
23,6,4,161,1,574,480,700,0,220,480,700,0,0,463,10,7,480,0,1815,1915,False,266,197,sebsi:0  marzouki:1  
23,6,4,160,4,559,411,600,0,189,411,600,0,0,396,9,6,411,0,1800,1925,False,163,233,sebsi:0  marzouki:1  
23,6,4,160,3,560,421,601,0,180,421,601,0,0,409,5,7,421,0,1815,1935,True,201,208,sebsi:1  marzouki:1  
23,6,4,160,2,560,442,600,0,158,442,600,0,0,436,4,2,442,0,1805,1908,True,201,235,sebsi:1  marzouki:1  
23,6,4,160,1,560,423,600,0,177,423,600,0,0,412,8,3,423,0,1830,1930,False,227,185,sebsi:1  marzouki:1  
23,6,3,159,4,497,326,600,0,274,326,600,0,0,312,6,8,326,0,1822,1915,False,125,187,sebsi:1  marzouki:1  
23,6,3,158,1,394,293,500,0,207,293,500,0,0,283,6,4,293,0,1815,1905,True,155,128,sebsi:1  marzouki:1  
23,6,3,157,1,588,399,700,1,300,399,700,0,0,386,8,5,399,0,1815,1915,False,162,224,sebsi:1  marzouki:1  
23,6,3,156,4,476,344,600,0,256,344,600,0,0,338,3,3,344,0,1825,1930,True,73,265,sebsi:1  marzouki:1  
23,6,3,156,3,478,375,601,0,226,375,601,0,0,372,2,1,375,0,1809,1930,False,76,296,sebsi:1  marzouki:1  
23,6,3,156,2,478,382,600,0,218,382,600,0,0,377,4,1,382,0,1816,1930,False,117,260,sebsi:1  marzouki:1  
23,6,3,156,1,478,378,600,0,222,378,600,0,0,370,7,1,378,0,,1915,False,155,215,sebsi:1  marzouki:1  
23,6,3,155,6,551,407,600,0,193,407,600,0,0,394,6,7,407,0,1815,1900,True,112,282,sebsi:1  marzouki:1  
23,6,3,155,5,556,424,600,1,175,424,600,0,0,418,3,3,424,0,1828,1930,True,135,283,sebsi:1  marzouki:1  
23,6,3,155,4,556,418,600,1,181,418,600,0,0,414,3,1,418,0,1850,1925,True,121,293,sebsi:1  marzouki:1  
23,6,3,155,3,556,453,600,0,147,453,600,0,0,448,1,4,453,0,1815,1932,False,147,301,sebsi:1  marzouki:1  
23,6,3,155,2,556,442,600,4,154,442,600,0,0,436,4,2,442,0,1830,1920,True,156,280,sebsi:0  marzouki:1  
23,6,3,155,1,556,463,600,1,136,463,600,0,0,452,9,2,463,0,1800,1920,True,214,238,sebsi:1  marzouki:1  
23,6,3,154,4,511,356,596,0,240,356,596,0,0,342,11,3,356,0,1800,1915,False,96,246,sebsi:1  marzouki:1  
23,6,3,154,3,512,397,600,0,203,397,600,0,0,395,2,0,397,0,1805,1900,False,123,272,sebsi:1  marzouki:1  
23,6,3,154,2,512,426,600,1,173,426,600,0,0,421,4,1,426,0,1815,1930,False,149,272,sebsi:1  marzouki:1  
23,6,3,154,1,512,386,600,0,216,384,600,0,2,377,4,3,384,0,18,1945,False,168,209,sebsi:0  marzouki:1  
23,6,3,153,4,486,366,600,0,234,366,600,0,0,364,0,2,366,0,1815,1900,False,113,251,sebsi:1  marzouki:1  
23,6,3,153,3,487,367,600,0,233,367,600,0,0,359,4,4,367,0,1803,1848,True,109,250,sebsi:1  marzouki:1  
23,6,3,153,2,487,382,598,0,216,382,598,0,0,381,1,0,382,0,1820,1915,True,138,243,sebsi:1  marzouki:1  
23,6,3,153,1,487,388,600,1,211,388,600,0,0,381,4,3,388,0,1805,1853,False,171,210,sebsi:1  marzouki:1  
23,6,3,152,5,576,401,700,0,299,401,700,0,0,387,6,8,401,0,1825,1935,True,139,248,sebsi:1  marzouki:1  
23,6,3,152,4,576,408,701,0,293,408,701,0,0,401,5,2,408,0,1835,1940,True,136,265,sebsi:1  marzouki:1  
23,6,3,152,3,576,439,691,0,252,439,691,0,0,432,4,3,439,0,1835,1935,True,133,299,sebsi:1  marzouki:1  
23,6,3,152,2,576,449,690,0,241,449,690,0,0,438,7,4,449,0,1830,1945,True,181,257,sebsi:1  marzouki:1  
23,6,3,152,1,576,438,700,2,260,438,700,0,0,434,2,2,438,0,1860,1930,True,199,235,sebsi:1  marzouki:1  
23,6,2,151,7,529,353,600,0,247,353,600,0,0,342,5,6,353,0,1815,1905,True,135,207,sebsi:1  marzouki:1  
23,6,2,151,6,531,374,600,0,226,374,600,0,0,370,4,0,374,0,1830,1920,False,147,223,sebsi:1  marzouki:1  
23,6,2,151,4,531,416,595,0,179,416,595,0,0,410,2,4,416,0,1814,1900,True,168,242,sebsi:1  marzouki:1  
23,6,2,151,3,531,415,600,1,184,415,600,0,0,404,6,5,415,0,1810,1855,True,178,226,sebsi:1  marzouki:1  
23,6,2,151,2,531,404,595,0,191,404,595,0,0,394,5,5,404,0,1820,2010,True,209,185,sebsi:1  marzouki:1  
23,6,2,151,1,531,437,600,1,162,437,600,0,0,428,5,4,437,0,1810,1920,True,232,196,sebsi:0  marzouki:1  
23,6,2,150,2,558,408,600,0,192,408,600,0,0,399,7,2,408,0,1815,1930,False,109,290,sebsi:1  marzouki:1  
23,6,2,150,1,558,457,603,0,146,457,603,0,0,448,6,3,457,0,1815,1930,True,171,277,sebsi:1  marzouki:1  
23,6,2,149,4,474,321,501,0,180,321,501,0,0,316,3,2,321,0,1825,1900,True,136,180,sebsi:1  marzouki:1  
23,6,2,149,3,474,347,500,0,153,347,500,0,0,342,2,3,347,0,1810,1915,False,151,191,sebsi:0  marzouki:1  
23,6,2,149,2,474,389,500,0,111,389,500,0,0,382,4,3,389,0,0,1925,True,199,183,sebsi:0  marzouki:1  
23,6,2,149,1,474,386,500,1,114,385,500,0,1,376,7,2,385,0,1820,1930,True,237,139,sebsi:1  marzouki:1  
23,6,1,148,5,482,348,600,0,252,348,600,0,0,342,1,5,348,0,1820,1910,True,118,224,sebsi:0  marzouki:1  
23,6,1,148,4,483,367,601,0,234,367,601,0,0,358,6,3,367,0,1810,1910,True,125,233,sebsi:1  marzouki:1  
23,6,1,148,3,483,399,600,0,201,399,600,0,0,389,5,5,399,0,1830,1930,False,139,250,sebsi:1  marzouki:1  
23,6,1,148,2,483,400,600,0,200,400,600,0,0,393,5,2,400,0,1830,1900,True,157,236,sebsi:1  marzouki:1  
23,6,1,148,1,483,392,600,0,208,392,600,0,0,386,4,2,392,0,1815,1900,True,178,208,sebsi:1  marzouki:1  
23,6,1,147,4,576,417,693,0,276,417,693,0,0,413,2,2,417,0,1800,1900,True,176,237,sebsi:1  marzouki:1  
23,6,1,147,3,578,458,700,1,241,458,700,0,0,443,10,5,458,0,1820,1920,True,195,248,sebsi:1  marzouki:1  
23,6,1,147,2,578,489,700,2,210,488,700,0,1,480,5,3,488,0,1826,2030,True,209,271,sebsi:1  marzouki:1  
23,6,1,147,1,578,445,700,1,255,444,700,0,1,438,6,0,444,0,1815,1915,True,219,219,sebsi:1  marzouki:1  
23,6,1,146,4,562,387,600,0,213,387,600,0,0,379,6,2,387,0,1830,1930,True,132,247,sebsi:1  marzouki:1  
23,6,1,146,3,562,404,600,0,196,404,600,0,0,394,5,5,404,0,1829,1920,True,176,218,sebsi:1  marzouki:1  
23,6,1,146,2,562,451,600,0,149,451,600,0,0,442,7,2,451,0,,,False,200,242,sebsi:1  marzouki:1  
23,6,1,146,1,562,457,600,1,142,457,600,0,0,445,9,3,457,0,1845,2000,True,235,210,sebsi:1  marzouki:1  
23,5,8,145,3,430,264,501,1,236,264,501,0,0,261,2,1,264,0,1810,1900,False,87,174,sebsi:1  marzouki:1  
23,5,8,145,2,431,313,504,0,191,313,504,0,0,306,3,4,313,0,1817,1850,True,101,205,sebsi:1  marzouki:1  
23,5,8,145,1,431,338,500,1,161,338,500,0,0,329,4,5,338,0,1815,1900,True,129,200,sebsi:1  marzouki:1  
23,5,8,144,2,329,203,400,0,197,203,400,0,0,195,5,3,203,0,1805,1850,False,78,117,sebsi:0  marzouki:1  
23,5,8,144,1,329,232,400,1,167,232,400,0,0,228,2,2,232,0,1800,1900,False,105,123,sebsi:1  marzouki:1  
23,5,8,143,5,522,388,600,0,212,388,600,0,0,383,1,4,388,0,1815,1900,False,135,248,sebsi:1  marzouki:1  
23,5,8,143,4,525,375,600,1,224,375,600,0,0,368,3,4,375,0,1815,1910,True,119,249,sebsi:1  marzouki:1  
23,5,8,143,3,525,425,600,0,175,425,600,0,0,418,6,1,425,0,1810,1915,True,175,243,sebsi:1  marzouki:1  
23,5,8,143,2,525,414,600,0,186,414,600,0,0,408,4,2,414,0,1810,1915,True,166,242,sebsi:1  marzouki:1  
23,5,8,143,1,525,434,600,0,166,434,600,0,0,428,4,2,434,0,,1900,True,224,204,sebsi:1  marzouki:1  
23,5,8,142,5,491,325,600,1,275,324,600,0,1,316,5,3,324,0,1820,1930,True,111,205,sebsi:1  marzouki:1  
23,5,8,142,4,491,353,600,0,247,353,600,0,0,342,5,6,353,0,1805,1850,True,132,210,sebsi:1  marzouki:1  
23,5,8,142,3,491,370,600,1,229,370,600,0,0,364,4,2,370,0,1815,1910,True,146,218,sebsi:1  marzouki:1  
23,5,8,142,2,491,390,600,1,209,390,600,0,0,388,1,1,390,0,1805,1855,True,182,206,sebsi:1  marzouki:1  
23,5,7,141,3,443,267,500,1,232,267,500,0,0,263,2,2,267,0,1815,1902,True,84,179,sebsi:1  marzouki:1  
23,5,7,141,2,444,290,500,0,210,290,500,0,0,288,0,2,290,0,1815,1900,False,96,192,sebsi:1  marzouki:1  
23,5,7,140,4,593,468,701,0,233,468,701,0,0,463,3,2,468,0,1830,1945,False,158,305,sebsi:1  marzouki:1  
23,5,7,140,3,593,487,701,0,214,487,701,0,0,475,8,4,487,0,1820,1930,False,171,304,sebsi:1  marzouki:1  
23,5,7,140,2,593,463,700,4,233,463,700,0,0,455,5,3,463,0,1820,1929,False,197,258,sebsi:1  marzouki:1  
23,5,7,140,1,593,472,700,0,228,472,700,0,0,457,10,5,472,0,1820,1915,False,205,252,sebsi:1  marzouki:1  
23,5,7,139,5,496,331,600,0,269,331,600,0,0,325,5,1,331,0,1830,1930,False,101,224,sebsi:1  marzouki:1  
23,5,7,139,4,498,324,600,0,276,324,600,0,0,322,2,0,324,0,1815,1900,False,133,189,sebsi:1  marzouki:1  
23,5,7,139,3,498,377,597,0,220,377,597,0,0,375,0,2,377,0,1830,1915,False,157,218,sebsi:1  marzouki:1  
23,5,7,139,2,498,392,600,0,208,392,600,0,0,385,4,3,392,0,1820,1905,True,165,220,sebsi:1  marzouki:1  
23,5,7,139,1,498,397,600,0,203,397,600,0,0,380,16,1,397,0,,1910,False,191,189,sebsi:1  marzouki:1  
23,5,6,138,6,503,296,600,1,303,296,600,0,0,287,3,6,296,0,1820,1900,False,127,160,sebsi:1  marzouki:1  
23,5,6,138,5,505,318,600,0,282,318,600,0,0,315,3,0,318,0,1815,1910,False,144,171,sebsi:1  marzouki:1  
23,5,6,138,4,505,335,600,0,265,335,600,0,0,328,6,1,335,0,1805,1900,False,141,187,sebsi:1  marzouki:1  
23,5,6,138,3,505,355,600,0,245,355,600,0,0,350,2,3,355,0,1815,1905,False,189,161,sebsi:1  marzouki:1  
23,5,6,138,2,505,354,602,0,248,354,602,0,0,339,13,2,354,0,1830,1930,False,196,143,sebsi:1  marzouki:1  
23,5,6,138,1,505,382,600,1,217,382,600,0,0,372,5,5,382,0,1810,1915,True,235,137,sebsi:1  marzouki:1  
23,5,6,137,5,538,291,609,0,318,291,609,0,0,281,8,2,291,0,1830,2000,True,117,164,sebsi:1  marzouki:1  
23,5,6,137,4,539,327,605,0,279,326,605,0,1,320,4,2,326,0,1830,1930,True,150,170,sebsi:1  marzouki:1  
23,5,6,137,3,539,346,600,0,254,346,600,0,0,345,1,0,346,0,1820,1900,True,160,185,sebsi:1  marzouki:1  
23,5,6,137,2,539,385,600,0,215,385,600,0,0,380,1,4,385,0,1815,1930,False,182,198,sebsi:1  marzouki:1  
23,5,6,137,1,539,396,600,7,197,396,600,0,0,381,9,6,396,0,1815,1933,True,186,195,sebsi:1  marzouki:1  
23,5,6,136,8,552,371,600,0,229,371,600,0,0,371,0,0,371,0,1815,1900,True,136,235,sebsi:1  marzouki:1  
23,5,6,136,6,556,362,599,0,237,362,599,0,0,358,2,2,362,0,1820,1915,False,147,211,sebsi:1  marzouki:1  
23,5,6,136,5,556,414,603,0,189,414,603,0,0,410,3,1,414,0,1815,1900,True,155,255,sebsi:1  marzouki:1  
23,5,6,136,4,556,437,600,0,163,437,600,0,0,430,5,2,437,0,1815,1903,False,194,236,sebsi:1  marzouki:1  
23,5,6,136,3,556,454,600,0,146,454,600,0,0,441,7,6,454,0,1830,1950,True,182,259,sebsi:1  marzouki:1  
23,5,6,136,2,556,414,605,1,190,414,605,0,0,407,5,2,414,0,1824,1930,True,184,223,sebsi:1  marzouki:1  
23,5,6,136,1,556,450,600,1,149,450,600,0,0,443,2,5,450,0,1845,1935,False,266,177,sebsi:1  marzouki:1  
23,5,6,135,3,537,318,600,0,282,318,600,0,0,317,0,1,318,0,1820,1900,True,117,200,sebsi:1  marzouki:1  
23,5,6,135,2,539,333,600,3,264,333,600,0,0,328,3,2,333,0,1830,1915,True,172,156,sebsi:1  marzouki:1  
23,5,6,135,1,539,385,600,1,214,385,600,0,0,379,1,5,385,0,1810,1915,True,204,175,sebsi:1  marzouki:1  
23,5,5,134,2,505,277,599,0,322,277,599,0,0,272,1,4,277,0,1820,1840,True,107,165,sebsi:1  marzouki:1  
23,5,5,134,1,506,344,601,4,253,344,601,0,0,340,3,1,344,0,1810,1950,True,199,141,sebsi:1  marzouki:1  
23,5,5,133,3,529,301,598,0,297,301,598,0,0,297,4,0,301,0,1805,1907,False,98,199,sebsi:1  marzouki:1  
23,5,5,133,2,531,368,590,0,222,368,590,0,0,360,5,3,368,0,1830,2000,False,157,203,sebsi:1  marzouki:1  
23,5,5,133,1,531,374,600,0,227,373,600,0,1,364,3,6,373,0,1811,1924,False,193,171,sebsi:1  marzouki:1  
23,5,5,132,4,492,311,601,0,290,311,601,0,0,304,4,3,311,0,1830,1850,True,127,177,sebsi:1  marzouki:1  
23,5,5,132,3,493,331,600,0,269,331,600,0,0,328,2,1,331,0,,,True,120,208,sebsi:1  marzouki:1  
23,5,5,132,2,493,382,600,0,219,381,600,0,1,376,5,0,381,0,1815,1910,True,159,217,sebsi:1  marzouki:1  
23,5,5,132,1,493,397,600,0,203,397,600,0,0,393,4,0,397,0,1815,1915,False,222,171,sebsi:1  marzouki:1  
23,5,4,131,1,597,388,700,1,311,388,700,0,0,383,2,3,388,0,1818,1910,False,84,299,sebsi:1  marzouki:1  
23,5,4,130,2,498,229,600,0,371,229,600,0,0,220,7,2,229,0,1800,1845,False,70,150,sebsi:1  marzouki:1  
23,5,4,130,1,499,282,600,0,318,282,600,0,0,271,9,2,282,0,1830,1900,True,115,156,sebsi:1  marzouki:1  
23,5,3,129,2,498,244,600,2,354,244,600,0,0,242,2,0,244,0,1820,1901,True,74,168,sebsi:1  marzouki:1  
23,5,3,129,1,498,345,600,1,254,345,600,0,0,338,5,2,345,0,1800,1900,False,142,196,sebsi:1  marzouki:1  
23,5,3,128,4,480,316,596,0,280,316,596,0,0,307,6,3,316,0,1815,1915,True,87,220,sebsi:1  marzouki:1  
23,5,3,128,3,483,355,600,0,245,355,600,0,0,350,5,0,355,0,1800,1930,True,85,265,sebsi:1  marzouki:1  
23,5,3,128,2,483,385,610,1,224,385,610,0,0,378,4,3,385,0,1820,1930,True,127,251,sebsi:1  marzouki:1  
23,5,3,128,1,483,366,600,2,232,366,600,0,0,351,8,7,366,0,1820,1930,False,128,223,sebsi:1  marzouki:1  
23,5,3,127,4,597,400,700,1,299,400,700,0,0,394,2,4,400,0,1820,1920,False,134,260,sebsi:1  marzouki:1  
23,5,3,127,3,599,405,700,1,294,405,700,0,0,400,3,2,405,0,1815,1850,False,129,271,sebsi:1  marzouki:1  
23,5,3,127,2,599,467,700,0,233,467,700,0,0,463,1,3,467,0,1820,1915,True,156,307,sebsi:1  marzouki:1  
23,5,3,127,1,599,464,699,2,233,464,699,0,0,450,10,4,464,0,1830,1915,False,208,242,sebsi:1  marzouki:1  
23,5,3,126,4,539,401,599,0,198,401,599,0,0,394,4,3,401,0,1830,1940,False,92,302,sebsi:1  marzouki:1  
23,5,3,126,3,542,400,602,0,202,400,602,0,0,393,5,2,400,0,1840,1930,True,90,303,sebsi:1  marzouki:1  
23,5,3,126,2,542,432,600,1,167,432,600,0,0,422,8,2,432,0,1815,2005,False,133,289,sebsi:1  marzouki:1  
23,5,3,126,1,542,425,600,0,175,425,600,0,0,419,4,2,425,0,1830,1950,False,143,276,sebsi:1  marzouki:1  
23,5,2,125,6,593,445,700,3,252,445,700,0,0,436,5,4,445,0,1815,1919,False,131,305,sebsi:1  marzouki:1  
23,5,2,125,5,597,425,700,0,274,426,700,0,1,420,3,3,426,0,1830,1930,True,148,272,sebsi:1  marzouki:1  
23,5,2,125,4,597,479,700,0,221,479,700,0,0,472,4,3,479,0,1810,1850,False,146,326,sebsi:1  marzouki:1  
23,5,2,125,3,597,497,700,0,203,497,700,0,0,488,4,5,497,0,1805,1914,False,174,314,sebsi:1  marzouki:1  
23,5,2,125,2,597,464,700,2,233,464,700,0,1,459,4,2,465,0,1830,1945,False,205,254,sebsi:1  marzouki:1  
23,5,2,125,1,597,489,700,1,210,489,700,0,0,476,5,8,489,0,1815,1920,False,234,242,sebsi:1  marzouki:1  
23,5,1,124,6,502,355,600,0,245,355,600,0,0,348,6,1,355,0,1815,1915,True,104,244,sebsi:1  marzouki:1  
23,5,1,124,5,506,357,600,0,243,357,600,0,0,350,4,3,357,0,1825,1925,False,127,223,sebsi:1  marzouki:1  
23,5,1,124,4,506,386,600,0,214,386,600,0,0,383,1,2,386,0,1840,1955,False,148,235,sebsi:1  marzouki:1  
23,5,1,124,3,506,402,600,0,198,402,600,0,0,399,2,1,402,0,1830,1925,False,138,261,sebsi:1  marzouki:1  
23,5,1,124,2,506,387,600,0,213,387,600,0,0,382,3,2,387,0,1830,1925,False,155,227,sebsi:1  marzouki:1  
23,5,1,124,1,506,383,600,0,217,383,600,0,0,373,5,5,383,0,1830,1930,False,156,217,sebsi:1  marzouki:1  
23,5,1,123,6,512,331,600,0,269,331,600,0,0,328,2,1,331,0,1831,1915,False,105,223,sebsi:1  marzouki:1  
23,5,1,123,5,512,356,600,0,244,356,600,0,0,352,3,1,356,0,1815,1915,True,124,228,sebsi:1  marzouki:1  
23,5,1,123,4,512,366,599,0,233,366,599,0,0,362,2,2,366,0,1800,1917,True,128,234,sebsi:1  marzouki:1  
23,5,1,123,3,512,406,600,0,194,406,600,0,0,402,1,3,406,0,1825,1919,True,163,239,sebsi:1  marzouki:1  
23,5,1,123,2,512,430,600,0,170,430,600,0,0,420,6,4,430,0,1820,1920,False,170,250,sebsi:1  marzouki:1  
23,5,1,123,1,512,407,600,0,193,407,600,0,0,392,6,9,407,0,1825,1915,False,181,211,sebsi:1  marzouki:1  
23,8,12,207,1,211,139,300,0,161,139,300,0,0,133,5,1,139,0,1815,1850,False,96,37,sebsi:1  marzouki:0  
23,8,12,206,1,196,108,300,1,191,108,300,0,0,107,1,0,108,0,1825,1900,False,63,44,sebsi:0  marzouki:0  
23,8,12,204,2,374,105,396,0,291,105,396,0,0,105,0,0,105,0,1810,1855,True,53,52,sebsi:1  marzouki:0  
23,8,12,204,1,374,207,400,0,193,207,400,0,0,204,2,1,207,0,1800,1835,True,127,77,sebsi:1  marzouki:0  
23,8,11,203,1,201,113,300,0,187,113,300,0,0,110,3,0,113,0,1815,1845,True,93,17,sebsi:1  marzouki:0  
23,8,11,202,1,397,209,499,3,287,209,499,0,0,206,3,0,209,0,1810,1855,False,101,105,sebsi:1  marzouki:1  
23,8,11,201,2,335,119,400,0,281,119,400,0,0,116,1,2,119,0,1810,1840,False,72,44,sebsi:1  :  
23,8,11,201,1,336,206,400,0,196,206,402,2,0,203,3,0,206,0,1830,1900,True,152,51,sebsi:1  marzouki:1  
23,8,10,200,2,314,169,400,0,231,169,400,0,0,167,1,1,169,0,1815,1915,False,52,115,sebsi:1  marzouki:1  
23,8,10,200,1,315,236,400,0,164,236,400,0,0,227,7,2,236,0,,1915,False,107,120,sebsi:1  marzouki:1  
23,8,10,199,1,186,127,200,0,74,126,200,0,1,123,1,2,126,0,1815,1930,True,71,52,sebsi:1  
23,8,10,198,2,390,240,488,0,248,240,488,0,0,233,6,1,240,0,1830,1915,False,50,183,sebsi:1  marzouki:1  
23,8,10,198,1,391,311,500,0,189,311,500,0,0,300,10,1,311,0,1815,1915,True,131,169,sebsi:1  marzouki:1  
23,8,10,197,1,141,88,200,0,112,88,200,0,0,87,1,0,88,0,1830,1900,False,28,59,sebsi:1  marzouki:1  
23,8,9,196,1,340,179,400,0,221,179,400,0,0,172,4,3,179,0,1830,1910,False,111,61,sebsi:1  marzouki:1  
23,8,9,195,1,411,192,500,0,308,192,500,0,0,183,9,0,192,0,1800,1850,True,69,114,marzouki:1  
23,8,8,194,1,461,166,500,0,334,166,500,0,0,164,2,0,166,0,1800,0,False,68,96,sebsi:  marzouki:  
23,8,8,193,1,342,197,396,0,199,197,396,0,0,192,5,0,197,0,1815,1855,False,58,134,sebsi:1  marzouki:1  
23,8,8,192,1,258,124,300,0,176,124,300,0,0,116,3,5,124,0,1810,1840,True,51,65,sebsi:1  marzouki:1  
23,8,8,191,1,219,122,300,0,178,122,300,0,0,116,4,2,122,0,1810,1850,True,76,40,sebsi:1  marzouki:1  
23,8,6,187,1,397,244,500,0,256,244,500,0,0,234,7,3,244,0,1815,1915,True,161,73,sebsi:1  
23,8,5,186,1,206,104,300,0,196,104,300,0,0,99,3,2,104,0,1815,1845,False,54,45,sebsi:1  
23,8,5,185,1,323,131,400,0,269,131,400,0,0,126,3,2,131,0,1800,1900,False,82,44,sebsi:1  
23,8,4,184,1,331,207,400,0,193,207,400,0,0,201,5,1,207,0,1815,1910,False,116,85,sebsi:1  
23,8,3,183,1,222,95,300,0,205,95,300,0,0,94,0,1,95,0,1800,1830,False,32,62,marzouki:1  
23,8,3,182,2,466,197,501,0,304,197,501,0,0,196,0,1,197,0,1810,1840,True,61,135,
23,8,3,182,1,466,309,500,0,191,309,500,0,0,303,3,3,309,0,,1900,False,146,157,marzouki:1  
23,8,2,181,1,422,199,500,0,301,199,500,0,0,196,2,1,199,0,1921,,True,77,119,
23,8,2,180,1,431,213,500,0,287,213,500,0,0,212,0,1,213,0,,1840,False,106,106,marzouki:1  
23,8,2,179,2,336,196,400,0,204,196,400,0,0,193,1,2,196,0,1815,1840,True,60,133,sebsi:1  marzouki:1  
23,8,2,179,1,337,241,400,0,159,241,400,0,0,238,3,0,241,0,1800,1835,True,127,111,sebsi:1  marzouki:1  
23,8,1,178,3,566,263,600,0,337,263,600,0,0,251,9,3,263,0,1830,1910,True,132,119,sebsi:1  marzouki:1  
23,8,1,178,2,567,354,600,0,246,354,600,0,0,348,4,2,354,0,1800,1855,False,210,138,sebsi:1  marzouki:2  
23,8,1,178,1,567,385,600,0,216,384,600,0,1,368,13,3,384,0,1805,1920,True,232,136,sebsi:1  marzouki:2  
23,7,7,177,1,506,356,600,2,242,356,600,0,0,328,21,7,356,0,1805,1910,True,273,55,sebsi:1  marzouki:1  
23,7,6,176,2,357,198,400,0,202,198,400,0,0,188,5,5,198,0,1810,1850,False,106,82,sebsi:1  marzouki:1  
23,7,6,176,1,357,212,400,0,188,212,400,0,0,205,7,0,212,0,1812,1842,False,154,51,sebsi:1  marzouki:1  
23,7,5,175,2,431,206,500,0,294,206,500,0,0,194,9,3,206,0,1815,1900,True,75,119,sebsi:1  marzouki:1  
23,7,5,175,1,432,240,500,3,257,240,500,0,0,236,2,2,240,0,1825,1915,True,150,86,sebsi:1  marzouki:1  
23,7,4,174,1,146,79,200,0,121,79,200,0,0,77,2,0,79,0,1815,1845,True,54,23,sebsi:1  marzouki:1  
23,7,4,173,3,481,236,600,0,364,236,600,0,0,226,5,5,236,0,1820,1850,True,78,148,sebsi:1  marzouki:1  
23,7,4,173,2,483,222,600,0,378,222,600,0,0,216,4,2,222,0,,1845,True,107,109,sebsi:1  marzouki:1  
23,7,4,173,1,483,258,600,0,342,258,600,0,0,249,6,3,258,0,1815,1930,True,154,95,sebsi:1  marzouki:1  
23,7,3,172,1,277,184,300,0,116,184,300,0,0,177,3,4,184,0,1815,1910,False,102,75,sebsi:1  marzouki:1  
23,7,2,171,1,581,349,700,11,340,349,700,0,0,337,8,4,349,0,1830,1915,False,214,123,sebsi:1  marzouki:1  
23,7,2,170,4,565,318,600,0,282,318,600,0,0,306,9,3,318,0,1815,1900,False,213,93,sebsi:1  marzouki:1  
23,7,2,170,3,566,357,600,0,243,357,600,0,0,350,4,3,357,0,1815,1915,False,254,96,sebsi:1  marzouki:1  
23,7,2,170,2,566,412,600,0,188,412,600,0,0,407,3,2,412,0,1805,1910,False,306,101,sebsi:1  marzouki:1  
23,7,2,170,1,566,421,600,1,178,421,600,0,0,404,13,4,421,0,1810,1900,True,310,94,sebsi:1  marzouki:1  
23,7,1,169,3,577,334,715,0,381,334,715,0,0,334,0,0,334,0,1815,1915,True,41,293,sebsi:1  marzouki:1  
23,7,1,169,2,578,412,700,2,286,412,700,0,0,402,8,2,412,0,1820,1913,True,70,332,sebsi:0  marzouki:1  
23,7,1,169,1,578,394,700,0,306,394,700,0,0,382,6,6,394,0,1805,1910,False,90,292,sebsi:1  marzouki:1  
23,4,8,122,1,319,121,400,0,279,121,400,400,0,118,3,0,121,0,1815,0,True,61,57,sebsi:0  marzouki:1  
23,4,8,121,1,425,177,500,1,322,177,500,0,0,174,3,0,177,0,,1835,True,48,126,sebsi:1  marzouki:1  
23,4,8,120,1,554,264,600,0,336,264,600,0,0,264,7,0,257,7,1830,1850,False,82,175,sebsi:1  marzouki:1  
23,4,7,119,2,395,173,500,0,327,173,500,0,0,171,2,0,173,0,1830,1900,False,94,77,sebsi:1  marzouki:1  
23,4,7,119,1,395,233,500,0,267,233,500,0,0,223,9,1,233,0,1830,1900,False,184,39,sebsi:0  marzouki:1  
23,4,7,118,2,506,298,619,0,321,298,619,0,0,290,7,1,298,0,1830,1930,False,111,179,sebsi:1  marzouki:1  
23,4,7,118,1,506,355,600,0,245,355,600,0,0,346,4,5,355,0,1815,1900,False,181,165,sebsi:1  marzouki:1  
23,4,6,117,1,416,178,500,0,322,178,500,0,0,174,4,0,178,0,1810,1830,True,122,52,sebsi:1  marzouki:1  
23,4,6,116,2,320,112,400,1,287,112,400,0,0,111,1,0,112,0,1830,1900,True,50,61,sebsi:1  marzouki:1  
23,4,6,116,1,321,206,400,0,194,206,400,0,0,198,4,4,206,0,1805,1845,True,138,60,sebsi:1  marzouki:1  
23,4,6,115,1,374,177,400,0,223,177,400,0,0,173,2,2,177,0,1815,1902,True,97,76,sebsi:1  marzouki:1  
23,4,6,114,3,443,179,500,0,321,179,500,0,0,175,4,0,179,0,1800,1900,True,98,77,sebsi:1  marzouki:1  
23,4,6,114,2,443,183,500,0,317,183,500,0,0,181,2,0,183,0,1815,1840,False,114,67,sebsi:1  marzouki:1  
23,4,6,114,1,443,261,501,0,240,261,501,0,0,252,9,0,261,0,1800,1850,False,170,82,sebsi:1  marzouki:1  
23,4,5,113,1,483,269,600,0,331,269,600,0,0,263,4,2,269,0,1800,1850,True,74,189,sebsi:1  marzouki:1  
23,4,5,112,2,387,178,502,0,324,178,502,0,0,172,4,2,178,0,1820,1845,False,63,109,sebsi:1  marzouki:1  
23,4,5,112,1,387,219,500,0,281,219,500,0,0,218,1,0,219,0,1800,1840,False,110,108,sebsi:0  marzouki:1  
23,4,4,111,1,443,303,500,0,197,303,500,0,0,301,1,1,303,0,1823,1915,True,77,224,sebsi:1  marzouki:1  
23,4,4,110,1,181,123,200,1,76,123,200,0,0,120,1,2,123,0,1820,1842,True,33,87,sebsi:1  marzouki:1  
23,4,4,109,2,464,250,500,0,250,250,500,0,0,248,2,0,250,0,1815,1900,True,32,216,sebsi:1  marzouki:1  
23,4,4,109,1,465,305,500,1,194,305,500,0,0,297,7,1,305,0,1820,1915,False,73,224,sebsi:1  marzouki:1  
23,4,4,108,3,555,341,600,0,259,341,600,0,0,336,4,1,341,0,1840,1913,False,49,287,sebsi:1  marzouki:1  
23,4,4,108,2,556,400,600,2,198,400,600,0,0,395,4,1,400,0,1815,1940,False,76,319,sebsi:1  marzouki:1  
23,4,4,108,1,556,408,600,0,192,408,600,0,0,334,11,3,408,0,1820,1915,False,159,235,sebsi:0  marzouki:1  
23,4,3,107,1,555,247,600,0,353,247,600,0,0,246,1,0,247,0,1815,1845,False,109,137,sebsi:1  marzouki:1  
23,4,3,106,2,337,164,400,1,235,164,400,0,0,161,1,2,164,0,1800,1833,True,63,98,sebsi:1  marzouki:1  
23,4,3,106,1,337,193,400,1,207,192,400,0,1,185,7,0,192,0,1815,1849,False,96,89,sebsi:1  marzouki:1  
23,4,2,105,1,435,166,500,0,334,166,500,0,0,163,3,0,166,0,1810,1830,True,74,89,sebsi:0  marzouki:1  
23,4,2,104,1,467,220,500,0,280,220,500,0,0,213,5,2,220,0,1815,1900,False,72,141,sebsi:1  marzouki:1  
23,4,2,103,2,378,166,400,0,234,166,400,0,0,152,13,1,166,0,1815,1845,False,32,120,sebsi:0  marzouki:1  
23,4,2,103,1,378,211,400,1,188,211,400,0,0,208,2,1,211,0,,1848,False,74,134,sebsi:1  marzouki:1  
23,4,2,102,1,407,216,500,0,284,216,500,0,0,211,2,3,216,0,1830,1950,False,31,180,sebsi:1  marzouki:1  
23,4,1,101,1,558,214,600,0,386,214,600,0,0,205,8,1,214,0,1819,1900,True,82,123,sebsi:1  marzouki:1  
23,4,1,100,2,453,245,500,1,254,245,500,0,0,232,9,4,245,0,1830,1905,False,97,135,sebsi:1  marzouki:1  
23,4,1,100,1,454,330,499,0,169,330,499,0,0,318,9,3,330,0,1820,1900,False,192,126,sebsi:1  marzouki:1  
23,4,1,99,3,538,277,600,0,323,277,600,0,0,261,11,5,277,0,1810,1900,False,106,155,sebsi:1  marzouki:1  
23,4,1,99,1,539,363,600,0,237,363,600,0,0,356,7,0,363,0,1815,1920,False,210,146,sebsi:1  marzouki:1  
23,4,1,98,5,580,249,700,0,451,249,700,0,0,219,26,4,249,0,1810,1855,True,110,109,sebsi:1  marzouki:1  
23,4,1,98,4,582,291,700,0,409,291,700,0,0,266,17,8,291,0,1805,1905,False,123,143,sebsi:1  marzouki:1  
23,4,1,98,3,582,366,700,0,334,366,700,0,0,354,9,3,366,0,1815,1915,False,204,150,sebsi:1  marzouki:1  
23,4,1,98,2,582,407,703,1,295,407,703,0,0,398,4,5,407,0,1820,1905,False,239,159,sebsi:1  marzouki:1  
23,4,1,98,1,582,371,700,1,328,371,700,0,0,362,7,2,371,0,1820,1900,True,254,108,sebsi:0  marzouki:1  
23,1,9,31,2,357,129,400,0,271,129,400,0,0,127,2,0,129,0,1805,1830,False,28,99,sebsi:1  marzouki:1  
23,1,9,31,1,357,186,400,1,213,186,400,0,0,182,3,1,186,0,1800,1850,False,101,81,sebsi:1  marzouki:1  
23,1,8,30,1,200,68,200,0,132,68,200,0,0,65,1,2,68,0,1810,1845,False,44,21,sebsi:1  marzouki:1  
23,1,8,29,1,306,144,400,0,256,144,400,0,0,140,3,1,144,0,1810,1850,False,85,55,sebsi:1  marzouki:1  
23,1,8,28,2,312,119,396,1,276,119,396,0,0,117,1,1,119,0,1815,1900,False,47,70,sebsi:1  marzouki:1  
23,1,7,27,1,274,151,297,0,146,151,297,0,0,149,2,0,151,0,1820,1900,False,64,85,sebsi:1  marzouki:1  
23,1,7,26,1,429,196,500,1,303,196,500,0,0,194,0,2,196,0,1815,1850,True,126,68,sebsi:1  marzouki:1  
23,1,7,25,2,561,316,600,0,284,316,600,0,0,315,0,1,316,0,1800,2000,False,20,295,sebsi:1  marzouki:1  
23,1,7,25,1,561,367,600,0,233,367,600,0,0,366,1,0,367,0,1800,1900,False,64,302,sebsi:1  marzouki:1  
23,1,6,24,1,517,280,600,0,320,280,600,0,0,274,3,3,280,0,1800,1845,False,70,204,sebsi:1  marzouki:1  
23,1,6,23,1,170,57,200,0,143,57,200,0,0,55,1,1,57,0,1815,1850,True,17,38,sebsi:1  marzouki:1  
23,1,6,22,2,327,115,400,0,285,115,400,0,0,104,7,4,115,0,1810,1900,True,29,75,sebsi:1  marzouki:1  
23,1,6,22,1,328,167,400,0,233,167,400,0,0,160,4,3,167,0,1805,1840,True,78,82,sebsi:1  marzouki:1  
23,1,6,21,1,498,228,600,1,371,228,600,0,0,222,3,3,228,0,1815,1845,False,131,91,sebsi:1  marzouki:1  
23,1,5,20,1,250,155,300,1,144,155,300,0,0,148,7,0,155,0,1805,1900,True,64,84,sebsi:1  marzouki:1  
23,1,5,19,1,416,186,500,0,314,186,500,0,0,173,8,5,186,0,1840,1920,True,70,103,sebsi:  marzouki:  
23,1,5,18,1,575,250,700,0,450,250,700,0,0,243,4,3,250,0,1820,1900,True,112,131,sebsi:1  marzouki:1  
23,1,5,17,2,418,168,500,0,332,168,500,0,0,165,2,1,168,0,1815,1847,False,68,97,sebsi:1  marzouki:1  
23,1,5,17,1,418,256,500,1,243,256,500,0,0,251,3,2,256,0,1810,1915,True,148,103,sebsi:1  marzouki:1  
23,1,4,16,1,338,170,400,0,230,170,400,0,0,165,2,3,170,0,1815,1900,True,86,79,sebsi:1  marzouki:1  
23,1,4,15,1,361,157,400,1,242,157,400,0,0,155,1,1,157,0,1820,1850,False,58,97,sebsi:1  marzouki:1  
23,1,4,14,1,427,214,501,0,287,214,501,1,0,210,4,0,214,0,1830,1915,True,123,87,sebsi:  marzouki:  
23,1,4,13,1,221,90,300,0,210,90,300,0,0,88,1,1,90,0,1813,1834,True,46,42,sebsi:1  marzouki:1  
23,1,3,12,1,199,85,300,0,215,85,300,0,0,84,1,0,85,0,1810,1840,False,42,42,sebsi:1  marzouki:1  
23,1,3,11,1,146,53,200,0,147,53,200,0,0,53,0,0,53,0,1830,1900,False,33,20,sebsi:1  marzouki:1  
23,1,3,10,2,491,105,600,0,195,105,600,0,0,105,0,0,105,0,1810,1827,False,58,47,sebsi:1  marzouki:1  
23,1,3,10,1,491,225,601,0,376,225,601,0,0,219,5,1,225,0,,1830,True,168,51,sebsi:1  marzouki:1  
23,1,3,9,1,527,256,600,1,343,256,600,0,0,252,3,1,256,0,1815,1905,True,200,52,sebsi:1  marzouki:1  
23,1,2,8,2,537,346,600,0,254,346,600,0,0,340,3,3,346,0,1830,1930,True,120,220,sebsi:1  marzouki:1  
23,1,2,8,1,538,398,600,0,202,398,600,0,0,385,11,2,398,0,1830,1900,True,165,220,sebsi:1  marzouki:1  
23,1,2,7,3,427,214,500,0,286,214,500,0,0,205,8,1,214,0,1815,1915,False,119,86,sebsi:1  marzouki:1  
23,1,2,7,2,428,268,500,0,232,268,500,0,0,267,1,0,268,0,1830,1924,False,158,109,sebsi:1  marzouki:1  
23,1,2,7,1,428,282,500,0,218,282,500,0,0,275,4,3,282,0,1845,1930,True,216,59,sebsi:1  marzouki:1  
23,1,1,6,2,342,110,400,1,289,110,400,0,0,106,0,4,110,0,1800,1840,False,68,38,sebsi:1  marzouki:1  
23,1,1,5,1,214,133,289,0,156,133,289,0,0,132,1,0,133,0,1800,1835,False,79,53,sebsi:1  marzouki:1  
23,1,1,4,2,426,275,500,0,225,275,500,0,0,270,2,3,275,0,1808,1845,True,135,135,sebsi:1  marzouki:1  
23,1,1,4,1,427,333,500,0,167,333,500,0,0,330,3,0,333,0,1810,1846,False,216,114,sebsi:1  marzouki:1  
23,1,1,3,2,326,117,400,0,283,117,400,0,0,115,2,0,117,0,1800,1830,False,47,68,sebsi:1  marzouki:1  
23,1,1,3,1,326,177,400,0,223,177,400,0,0,172,5,0,177,0,1805,1825,False,120,52,sebsi:1  marzouki:0  
23,1,1,2,2,482,123,600,0,477,123,600,0,0,118,2,3,123,0,1815,1845,True,60,58,sebsi:1  marzouki:1  
23,1,1,2,1,482,194,600,0,406,194,600,0,0,188,6,0,194,0,1800,1930,True,126,62,sebsi:1  marzouki:1  
23,1,1,1,6,551,329,600,0,271,329,600,0,0,314,9,6,329,0,1830,,True,152,162,sebsi:1  marzouki:1  
23,1,1,1,5,554,266,600,1,333,266,600,0,0,260,5,1,266,0,1825,1900,False,136,124,sebsi:1  marzouki:1  
23,1,1,1,4,554,279,600,0,321,279,600,0,0,278,1,0,279,0,1830,1900,False,135,143,sebsi:1  marzouki:1  
23,1,1,1,3,554,358,600,0,243,357,600,0,0,352,4,1,357,0,1830,1930,False,220,132,sebsi:1  marzouki:1  
23,1,1,1,2,554,384,600,2,214,384,600,0,0,375,4,5,384,0,1830,1930,False,225,150,sebsi:1  marzouki:1  
23,1,1,1,1,554,388,600,0,212,388,600,0,0,382,2,4,388,0,1810,1915,True,297,85,sebsi:1  marzouki:1  
23,2,6,46,2,400,181,500,0,319,181,500,0,0,181,0,0,181,0,1810,1850,True,48,133,sebsi:1  marzouki:1  
23,2,6,46,1,401,235,500,0,265,235,500,0,0,229,5,1,235,0,1830,1900,True,101,128,sebsi:1  marzouki:1  
23,2,6,45,2,337,150,400,0,250,150,400,0,0,144,4,2,150,0,1815,1845,False,55,89,sebsi:1  marzouki:1  
23,2,6,45,1,338,224,400,0,176,224,400,0,0,221,2,1,224,0,1815,1845,False,121,100,sebsi:1  marzouki:1  
23,2,6,44,1,332,205,400,0,195,205,400,0,0,202,2,1,205,0,1826,1901,False,75,127,sebsi:1  marzouki:1  
23,2,5,43,3,563,280,600,0,320,280,600,0,0,278,0,2,280,0,1820,1850,False,75,203,sebsi:1  marzouki:1  
23,2,5,43,2,563,308,600,1,291,308,600,0,0,303,5,0,308,0,1830,1915,False,75,228,sebsi:1  marzouki:1  
23,2,5,43,1,563,334,600,0,266,334,600,0,0,332,1,1,334,0,1820,1900,True,144,188,sebsi:1  marzouki:1  
23,2,4,42,1,336,142,400,0,258,142,400,0,0,139,2,1,142,0,1830,1855,True,64,75,sebsi:1  marzouki:1  
23,2,4,41,2,408,161,500,0,339,161,500,0,0,153,4,4,161,0,1810,1845,True,37,116,sebsi:1  marzouki:1  
23,2,4,41,1,409,219,500,0,281,219,500,0,0,212,4,3,219,0,1820,1849,True,107,105,sebsi:1  marzouki:1  
23,2,4,40,1,459,219,500,0,281,219,500,0,0,214,5,0,219,0,1810,1900,True,121,93,sebsi:1  marzouki:1  
23,2,3,39,1,282,203,300,0,97,203,300,0,0,202,1,0,203,0,1800,1840,False,17,185,sebsi:1  marzouki:1  
23,2,3,38,1,503,266,600,0,334,266,600,0,0,261,2,3,266,0,1818,1910,False,97,164,sebsi:1  marzouki:1  
23,2,3,37,2,345,146,400,0,254,146,400,0,0,143,2,1,146,0,1810,1851,True,43,100,sebsi:1  marzouki:1  
23,2,3,37,1,346,192,400,0,208,192,400,0,0,187,3,2,192,0,1820,1915,True,64,123,sebsi:1  marzouki:1  
23,2,2,36,2,424,229,500,1,270,229,500,0,0,221,5,3,229,0,1840,1910,True,31,190,sebsi:1  marzouki:1  
23,2,2,36,1,424,257,500,0,243,257,500,0,0,251,2,4,257,0,1810,1845,True,85,166,sebsi:1  marzouki:1  
23,2,2,35,3,468,249,500,0,251,249,500,0,0,248,1,0,249,0,1820,1851,False,17,231,sebsi:1  marzouki:1  
23,2,2,35,2,468,278,501,1,222,278,501,0,0,275,2,1,278,0,1815,1927,True,28,247,sebsi:1  marzouki:1  
23,2,2,35,1,468,309,500,1,190,309,500,0,0,305,4,0,309,0,1820,1850,False,32,273,sebsi:1  marzouki:1  
23,2,1,34,1,306,168,400,0,232,168,400,0,0,166,2,0,168,0,1830,1835,True,23,143,sebsi:1  marzouki:1  
23,2,1,33,2,350,169,400,0,231,169,400,0,0,162,6,1,169,0,180,1850,True,56,106,sebsi:1  marzouki:1  
23,2,1,33,1,351,217,400,0,182,217,399,1,0,203,9,5,217,0,1815,1910,False,105,98,sebsi:1  marzouki:1  
23,2,1,32,4,536,274,600,0,326,274,600,0,0,269,3,2,274,0,1830,1900,False,59,210,sebsi:1  marzouki:1  
23,2,1,32,3,539,307,600,0,293,307,600,0,0,302,2,3,307,0,1820,1920,True,100,202,sebsi:1  marzouki:1  
23,2,1,32,2,539,356,600,0,244,356,600,0,0,352,1,3,356,0,1801,1910,False,132,220,sebsi:1  marzouki:1  
23,2,1,32,1,539,349,600,0,251,349,600,0,0,341,5,3,349,0,1810,1930,True,181,160,sebsi:1  marzouki:1  
23,3,12,97,1,134,48,200,0,152,48,200,0,0,48,0,0,48,0,1815,1800,True,36,12,sebsi:1  marzouki:1  
23,3,12,96,1,336,181,400,1,218,181,400,0,0,178,3,0,181,0,1800,1851,True,102,76,sebsi:1  marzouki:1  
23,3,12,95,1,155,78,200,0,122,78,200,0,0,78,0,0,78,0,1830,1930,True,44,34,sebsi:1  marzouki:1  
23,3,12,94,1,268,155,300,0,145,155,300,0,0,152,3,0,155,0,1815,1915,False,51,101,sebsi:0  marzouki:1  
23,3,12,93,1,215,119,300,0,181,119,300,0,0,114,3,2,119,0,1815,1855,False,53,61,sebsi:1  marzouki:1  
23,3,12,92,1,300,164,400,0,236,164,400,0,0,161,2,1,164,0,1810,1839,True,76,85,sebsi:1  marzouki:1  
23,3,12,91,1,390,167,500,0,333,167,500,0,0,156,7,4,167,0,1805,1840,False,69,87,sebsi:0  marzouki:1  
23,3,12,90,2,406,177,500,0,323,177,500,0,0,172,0,5,177,0,1805,1833,True,75,97,sebsi:1  marzouki:0  
23,3,12,90,1,406,244,500,0,256,244,500,0,0,235,8,1,244,0,1805,1845,True,124,111,sebsi:1  marzouki:1  
23,3,11,89,1,225,136,300,0,164,136,300,0,0,133,1,2,136,0,1805,1840,True,57,76,sebsi:1  marzouki:1  
23,3,11,88,1,235,85,300,0,215,85,300,0,0,85,0,0,85,0,1820,1835,True,37,48,sebsi:1  marzouki:1  
23,3,11,87,1,270,115,300,0,185,115,300,0,0,115,0,0,115,0,1800,1850,False,43,72,sebsi:1  marzouki:1  
23,3,11,86,1,340,193,400,0,207,193,400,0,0,190,1,2,193,0,1830,1906,True,90,100,sebsi:1  marzouki:1  
23,3,11,85,1,402,183,500,1,316,183,500,0,0,178,1,4,183,0,1820,0,True,86,92,sebsi:0  marzouki:1  
23,3,10,84,1,173,71,200,0,129,71,200,0,0,70,1,0,71,0,1800,1825,False,7,63,sebsi:1  marzouki:0  
23,3,10,83,1,188,84,200,0,116,84,200,0,0,84,0,0,84,0,1805,1845,False,29,55,sebsi:1  marzouki:1  
23,3,10,82,1,474,185,500,0,315,185,500,0,0,181,4,0,185,0,1810,1900,False,58,123,sebsi:1  marzouki:1  
23,3,10,81,1,472,183,500,0,317,183,500,0,0,179,0,4,183,0,1830,2000,False,139,40,sebsi:1  marzouki:1  
23,3,9,79,1,249,144,300,0,156,144,300,0,0,144,0,0,144,0,1800,1835,False,29,115,sebsi:1  marzouki:1  
23,3,9,78,1,331,144,400,0,256,144,400,0,0,143,0,1,144,0,1800,1840,True,37,106,sebsi:1  marzouki:1  
23,3,9,77,1,186,79,200,0,121,79,200,0,0,74,4,1,79,0,1800,1900,False,20,54,sebsi:0  marzouki:1  
23,3,9,76,1,408,180,500,10,310,180,500,0,0,176,3,1,180,0,1830,1900,True,53,123,sebsi:1  marzouki:1  
23,3,8,75,1,175,60,200,0,140,60,200,0,0,58,2,0,60,0,1830,1900,False,23,35,sebsi:0  marzouki:0  
23,3,8,74,1,357,115,400,0,285,115,400,0,0,110,5,0,115,0,1810,1850,False,47,63,sebsi:1  marzouki:1  
23,3,8,73,1,320,158,400,1,241,158,400,0,0,153,4,1,158,0,1800,1900,True,102,51,sebsi:1  marzouki:1  
23,3,8,72,2,361,91,400,0,309,91,400,0,0,90,1,0,91,0,1800,1845,False,28,62,sebsi:1  marzouki:0  
23,3,8,72,1,361,176,400,0,224,176,400,0,0,170,6,0,176,0,1810,1840,False,87,83,sebsi:1  marzouki:0  
23,3,7,71,1,61,33,100,0,67,33,100,0,0,30,3,0,33,0,1800,1845,False,16,14,sebsi:0  marzouki:1  
23,3,7,70,1,150,76,201,0,125,76,201,0,0,73,3,0,76,0,1800,1900,False,12,61,sebsi:1  marzouki:1  
23,3,7,69,1,205,109,300,0,191,109,300,0,0,109,0,0,109,0,1800,1800,False,54,55,sebsi:1  marzouki:1  
23,3,7,68,1,248,132,300,0,168,132,300,0,0,132,0,0,132,0,1805,1900,False,58,74,sebsi:1  marzouki:1  
23,3,7,67,1,322,239,400,0,161,239,400,0,0,236,1,2,239,0,1805,,False,40,196,sebsi:1  marzouki:1  
23,3,7,66,2,354,142,400,0,258,142,400,0,0,139,3,0,142,0,1800,1840,True,30,109,sebsi:1  marzouki:1  
23,3,7,66,1,355,194,400,0,206,194,400,0,0,186,5,3,194,0,1810,1850,True,88,98,sebsi:1  marzouki:1  
23,3,6,65,1,439,234,499,0,265,234,499,0,0,228,5,1,234,0,1820,1920,True,26,202,sebsi:1  marzouki:1  
23,3,6,64,1,347,249,399,0,150,249,399,0,0,247,2,0,249,0,1815,1905,False,69,178,sebsi:1  marzouki:1  
23,3,5,63,1,176,116,200,0,84,116,200,0,0,113,3,0,116,0,1805,1835,False,77,36,sebsi:1  marzouki:0  
23,3,5,62,1,257,90,300,0,210,90,300,0,0,86,2,2,90,0,1805,1830,False,61,25,sebsi:1  marzouki:0  
23,3,5,61,1,148,85,200,0,115,85,200,0,0,85,0,0,85,0,1805,1830,False,41,44,sebsi:1  marzouki:0  
23,3,5,60,1,522,225,599,0,374,225,599,0,0,215,10,0,225,0,1800,1903,False,154,61,sebsi:1  marzouki:0  
23,3,4,59,1,188,91,200,0,109,91,200,0,0,90,1,0,91,0,1805,1830,False,58,32,sebsi:1  marzouki:1  
23,3,3,58,1,232,127,300,0,173,127,300,0,0,122,4,1,127,0,1820,1900,True,30,92,sebsi:1  marzouki:1  
23,3,3,57,2,398,258,500,1,241,258,500,0,0,254,3,1,258,0,1805,1900,True,41,213,sebsi:1  marzouki:1  
23,3,3,57,1,399,267,500,0,233,267,500,0,0,262,2,3,267,0,1800,1847,True,105,157,sebsi:1  marzouki:1  
23,3,3,56,1,552,431,600,1,168,431,600,0,0,425,4,2,431,0,1810,1930,False,134,291,sebsi:1  marzouki:1  
23,3,2,55,1,164,87,200,0,113,87,200,0,0,84,2,1,87,0,1810,1835,True,50,34,sebsi:1  marzouki:1  
23,3,2,54,1,270,128,300,0,172,128,300,0,0,125,1,2,128,0,1820,1955,True,74,51,sebsi:1  marzouki:1  
23,3,2,53,1,108,64,200,0,136,64,200,0,0,63,0,1,64,0,1800,1820,False,56,7,sebsi:0  marzouki:1  
23,3,2,52,1,203,129,300,0,171,129,300,0,0,127,2,0,129,0,1835,1900,False,69,58,sebsi:1  marzouki:0  
23,3,2,51,1,478,229,600,1,370,229,600,0,0,228,0,1,229,0,1815,1845,False,109,119,sebsi:1  marzouki:1  
23,3,2,50,1,435,198,500,0,302,198,500,0,0,193,3,2,198,0,1815,1848,True,132,61,sebsi:1  marzouki:1  
23,3,1,49,1,488,323,600,0,277,323,600,0,0,317,1,5,323,0,1830,1930,True,136,181,sebsi:1  marzouki:1  
23,3,1,48,2,473,223,500,0,277,223,500,0,0,223,0,0,223,0,1820,1911,False,66,157,sebsi:1  marzouki:1  
23,3,1,48,1,473,300,500,1,199,300,500,0,0,292,5,3,300,0,1815,1903,False,129,163,sebsi:1  marzouki:1  
23,3,1,47,4,460,223,500,0,277,223,500,0,0,216,3,4,223,0,1805,1845,False,75,141,sebsi:1  marzouki:1  
23,3,1,47,3,461,249,500,0,251,249,500,0,0,235,10,4,249,0,1800,1900,True,96,139,sebsi:1  marzouki:1  
23,3,1,47,2,461,321,500,0,179,321,500,0,0,317,3,1,321,0,1810,1845,False,152,165,sebsi:1  marzouki:1  
23,3,1,47,1,461,326,500,0,174,326,500,0,0,320,4,2,326,0,1820,1905,False,190,130,sebsi:1  marzouki:1  
