circonscriptionId,delegationId,subDelegationId,centerID,stationId,registeredVoters,aSigningVoters,bDeliveredBallots,cSpoiledBallots,dLeftBallots,fExtractedBallots,gEplusF,hBminusG,iAminusF,jListVotes,kCancelledVotes,lBlankVotes,mJplusKplusL,nFminusM,countingStart,countingEnd,tampon,sebsi,marzouki,observers
26,6,16,163,1,551,329,600,2,269,329,600,0,0,323,2,4,329,0,1820,1915,True,100,223,sebsi:1  marzouki:1  
26,6,16,162,2,402,205,500,0,295,205,500,0,0,201,1,3,205,0,180,1850,True,60,141,sebsi:1  marzouki:1  
26,6,16,162,1,402,274,496,1,221,274,496,0,0,266,5,3,274,0,1805,1900,True,102,164,sebsi:1  marzouki:1  
26,6,15,161,3,444,235,499,2,262,235,499,0,0,232,1,2,235,0,1832,1930,True,91,141,sebsi:1  marzouki:1  
26,6,15,161,2,446,326,500,1,173,326,500,0,0,318,5,3,326,0,1815,1845,True,153,165,sebsi:1  marzouki:1  
26,6,15,161,1,446,320,500,1,179,320,500,0,0,313,5,2,320,0,1820,1850,True,173,140,sebsi:1  marzouki:1  
26,6,14,160,3,415,250,500,1,249,250,500,0,0,246,3,1,250,0,1840,1940,True,34,212,sebsi:1  marzouki:1  
26,6,14,160,2,417,285,500,0,215,285,500,0,0,278,6,1,285,0,1830,1920,True,59,219,sebsi:1  marzouki:1  
26,6,14,160,1,417,295,500,1,204,295,500,0,0,286,5,4,295,0,1800,1935,True,92,194,sebsi:1  marzouki:1  
26,6,14,159,3,534,269,600,0,331,269,600,0,0,265,1,3,269,0,1815,1906,True,32,233,sebsi:1  marzouki:1  
26,6,14,159,2,536,352,393,0,241,352,593,0,0,341,8,3,352,0,1835,1917,True,70,271,sebsi:1  marzouki:1  
26,6,14,159,1,536,324,600,1,275,324,600,0,0,317,5,2,324,0,1818,1914,True,114,203,sebsi:1  marzouki:1  
26,6,13,158,1,226,133,300,0,167,133,300,0,0,130,3,0,133,0,1805,1840,True,32,98,sebsi:1  marzouki:1  
26,6,13,157,1,164,104,300,0,196,104,300,0,0,102,0,2,104,0,1805,1823,True,35,67,sebsi:1  marzouki:1  
26,6,13,156,2,421,273,500,0,227,273,500,0,0,267,6,0,273,0,1820,1919,True,61,206,sebsi:1  marzouki:1  
26,6,13,156,1,421,296,500,0,204,296,500,0,0,291,4,1,296,0,1820,1910,True,107,184,sebsi:1  marzouki:1  
26,6,12,155,2,305,200,400,0,200,200,400,0,0,200,0,0,200,0,1815,1900,True,16,184,sebsi:1  marzouki:1  
26,6,12,155,1,306,223,400,0,177,223,400,0,0,223,0,0,223,0,,1840,True,34,189,sebsi:1  marzouki:1  
26,6,11,154,1,370,163,500,1,336,163,500,0,0,161,2,0,163,0,1808,1846,True,36,125,sebsi:1  marzouki:1  
26,6,11,153,1,217,125,300,0,175,125,300,0,0,124,1,0,125,0,1810,1845,True,15,109,sebsi:1  marzouki:1  
26,6,10,152,3,422,242,500,0,258,242,500,0,0,236,6,0,242,0,1810,1920,True,20,216,sebsi:1  marzouki:1  
26,6,10,152,2,424,305,496,0,191,305,496,0,0,299,3,3,305,0,1800,1900,True,51,248,sebsi:1  marzouki:1  
26,6,10,152,1,424,272,500,0,228,272,500,0,0,265,6,1,272,0,1805,1900,True,65,200,sebsi:1  marzouki:1  
26,6,10,151,1,304,192,400,1,207,192,400,0,0,192,0,0,192,0,1800,1845,True,34,158,sebsi:1  marzouki:1  
26,6,9,150,2,431,234,500,1,265,234,500,0,0,230,3,1,234,0,1815,1850,True,40,190,sebsi:1  marzouki:1  
26,6,9,150,1,431,272,500,0,228,272,500,0,0,266,6,0,272,0,1815,1900,True,79,187,sebsi:1  marzouki:1  
26,6,8,149,1,201,130,300,0,171,129,300,0,1,125,4,0,129,0,1825,1930,True,22,103,sebsi:1  marzouki:1  
26,6,8,148,1,501,283,600,0,317,283,600,0,0,277,4,2,283,0,1803,1901,True,98,179,sebsi:1  marzouki:1  
26,6,8,147,3,587,311,696,0,385,311,696,0,0,308,2,1,311,0,1815,1915,True,49,259,sebsi:1  marzouki:1  
26,6,8,147,2,588,372,700,1,327,372,700,0,0,366,3,3,372,0,1810,1852,True,75,291,sebsi:1  marzouki:1  
26,6,8,147,1,588,384,700,0,316,384,700,0,0,376,6,2,384,0,1800,1900,True,153,223,sebsi:1  marzouki:1  
26,6,7,146,1,117,64,200,0,136,64,200,0,0,62,2,0,64,0,1805,1900,True,18,44,sebsi:1  marzouki:1  
26,6,7,145,2,418,226,500,0,274,226,500,0,0,222,2,2,226,0,1820,1910,True,36,186,sebsi:1  marzouki:1  
26,6,7,145,1,418,291,500,0,209,291,500,0,0,282,4,5,291,0,1820,1930,True,108,174,sebsi:1  marzouki:1  
26,6,7,144,2,504,273,600,0,327,273,600,0,0,269,3,1,273,0,1834,1910,True,45,224,sebsi:1  marzouki:1  
26,6,7,144,1,505,305,600,2,293,305,600,0,0,298,2,5,305,0,1815,1930,True,90,208,sebsi:1  marzouki:1  
26,6,7,143,3,513,275,600,1,324,275,600,0,0,271,2,2,275,0,1805,1910,True,64,207,sebsi:1  marzouki:1  
26,6,7,143,2,515,375,600,0,225,375,600,0,0,365,2,8,375,0,1820,1925,True,104,261,sebsi:1  marzouki:1  
26,6,7,143,1,515,368,600,0,232,368,600,0,0,363,2,3,368,0,1820,1920,True,143,220,sebsi:1  marzouki:1  
26,6,6,142,3,468,255,499,0,244,255,499,0,0,252,1,2,255,0,1815,1930,True,88,164,sebsi:1  marzouki:1  
26,6,6,142,2,470,334,600,0,266,334,600,0,0,330,2,2,334,0,1830,1915,True,133,197,sebsi:1  marzouki:1  
26,6,6,142,1,470,334,600,0,266,334,600,0,0,325,2,7,334,0,1830,1915,True,159,166,sebsi:1  marzouki:1  
26,6,6,141,4,517,236,600,0,364,236,600,0,0,232,4,0,236,0,1830,1904,True,75,157,sebsi:1  marzouki:1  
26,6,6,141,3,519,271,600,0,329,271,600,0,0,267,2,2,271,0,1815,1900,True,97,170,sebsi:1  marzouki:1  
26,6,6,141,2,519,375,600,1,224,375,600,0,0,372,2,1,375,0,1820,1925,True,197,175,sebsi:1  marzouki:1  
26,6,6,141,1,519,315,600,0,285,315,600,0,0,309,3,3,315,0,1810,1830,True,175,134,sebsi:1  marzouki:1  
26,6,5,140,2,477,233,600,1,366,233,600,0,0,231,2,0,233,0,1830,1920,True,43,188,sebsi:1  marzouki:1  
26,6,5,140,1,477,311,600,0,289,311,600,0,0,302,5,4,311,0,1830,1912,True,108,194,sebsi:1  marzouki:1  
26,6,5,139,3,467,267,500,0,233,267,500,0,0,262,2,3,267,0,1900,1945,True,36,226,sebsi:1  marzouki:1  
26,6,5,139,2,467,339,500,1,160,339,500,0,0,329,5,5,339,0,1835,1935,True,71,258,sebsi:1  marzouki:1  
26,6,5,139,1,467,316,500,0,184,316,500,0,0,308,3,5,316,0,1800,1940,True,110,198,sebsi:1  marzouki:1  
26,6,3,137,2,599,378,700,0,322,378,700,0,0,374,4,0,378,0,1820,1930,True,100,274,sebsi:1  marzouki:1  
26,6,3,137,1,600,436,701,0,265,436,701,0,0,425,9,2,436,0,1815,1951,True,170,255,sebsi:1  marzouki:1  
26,6,3,136,2,399,244,500,1,255,244,500,0,0,240,1,3,244,0,1810,1850,True,62,178,sebsi:1  marzouki:1  
26,6,3,136,1,399,274,500,1,225,274,500,0,0,270,3,1,274,0,1815,1900,True,88,182,sebsi:1  marzouki:1  
26,6,2,135,2,385,215,500,1,284,215,500,0,0,208,2,5,215,0,1810,1850,True,45,163,sebsi:1  marzouki:1  
26,6,2,135,1,385,270,500,0,230,270,500,0,0,267,0,3,270,0,1820,1900,True,82,185,sebsi:1  marzouki:1  
26,6,2,134,3,401,213,500,0,287,213,500,0,0,208,2,3,213,0,1810,1840,True,39,169,sebsi:1  marzouki:1  
26,6,2,134,2,402,267,500,0,233,267,500,0,0,264,0,3,267,0,1800,1920,True,66,198,sebsi:1  marzouki:1  
26,6,2,134,1,402,268,500,2,230,268,500,0,0,265,2,1,268,0,1810,1905,True,104,161,sebsi:1  marzouki:1  
26,6,1,133,2,310,188,400,0,212,188,400,0,0,186,1,1,188,0,1814,1859,True,43,143,sebsi:1  marzouki:1  
26,6,1,133,1,310,222,400,1,177,222,400,0,0,218,3,1,222,0,1815,1900,True,79,139,sebsi:1  marzouki:1  
26,6,1,132,1,71,28,100,0,72,28,100,0,0,28,0,0,28,0,1815,1835,True,4,24,sebsi:1  marzouki:1  
26,6,1,131,1,426,239,500,0,261,239,500,0,0,233,3,3,239,0,1825,1905,True,78,155,sebsi:1  marzouki:1  
26,6,1,130,2,520,316,600,0,284,316,600,0,0,315,1,0,316,0,1820,1915,True,73,242,sebsi:1  marzouki:1  
26,6,1,130,1,520,384,600,0,216,384,600,0,0,379,3,2,384,0,1830,2010,True,128,251,sebsi:1  marzouki:1  
26,6,1,129,2,496,294,600,0,306,294,600,0,0,286,6,2,294,0,1816,1900,True,46,240,sebsi:1  marzouki:1  
26,6,1,129,1,497,345,600,0,255,345,600,0,0,339,6,0,345,0,1815,1933,True,115,224,sebsi:1  marzouki:1  
26,6,1,128,6,512,280,600,0,320,280,600,0,0,276,2,2,280,0,,1850,True,53,223,sebsi:1  marzouki:1  
26,6,1,128,5,517,313,600,0,287,313,600,0,0,307,2,4,313,0,1830,1850,True,67,240,sebsi:1  marzouki:1  
26,6,1,128,4,517,354,599,0,245,354,599,0,0,348,4,2,354,0,1820,1930,True,88,260,sebsi:1  marzouki:1  
26,6,1,128,2,517,369,600,0,231,369,600,0,0,363,5,1,369,0,1808,1901,True,147,216,sebsi:1  marzouki:1  
26,6,1,128,1,517,365,600,0,235,365,600,0,0,356,4,5,365,0,1815,,True,170,186,sebsi:1  marzouki:1  
26,7,10,191,1,166,116,200,0,84,116,200,0,0,116,0,0,116,0,1800,1821,True,14,102,sebsi:1  marzouki:1  
26,7,10,190,1,516,380,600,0,220,380,600,0,0,372,6,2,380,0,1800,,True,85,287,sebsi:1  marzouki:1  
26,7,10,189,1,384,242,500,0,258,242,500,0,0,235,6,1,242,0,1820,1850,True,60,175,sebsi:1  marzouki:1  
26,7,9,188,1,582,254,699,0,445,254,699,0,0,244,8,2,254,0,1800,,True,14,230,sebsi:1  marzouki:1  
26,7,9,187,1,597,324,700,1,375,324,700,0,0,309,14,1,324,0,1815,,True,19,290,sebsi:1  marzouki:1  
26,7,8,186,1,265,167,300,0,133,167,300,0,0,166,0,1,167,0,1831,1851,True,15,151,sebsi:1  marzouki:1  
26,7,7,185,1,443,313,500,0,187,313,500,0,0,308,2,3,313,0,1830,1915,True,18,290,sebsi:1  marzouki:1  
26,7,7,184,1,13,9,99,0,90,9,99,0,0,9,0,0,9,0,1805,1815,True,6,3,sebsi:1  marzouki:1  
26,7,7,183,1,467,339,500,0,161,339,500,0,0,334,2,3,339,0,1815,1900,True,59,275,sebsi:1  marzouki:1  
26,7,7,182,2,305,203,400,0,197,203,400,0,0,201,2,0,203,0,1800,1850,True,19,182,sebsi:1  marzouki:1  
26,7,7,182,1,306,261,400,2,137,261,400,0,0,256,4,1,261,0,1830,1915,True,40,216,sebsi:1  marzouki:1  
26,7,6,181,1,142,117,200,0,83,117,200,0,0,114,2,1,117,0,1815,1900,True,29,85,sebsi:1  marzouki:1  
26,7,6,180,1,59,41,100,0,59,41,100,0,0,41,0,0,41,0,1815,1837,True,14,27,sebsi:1  marzouki:1  
26,7,6,179,1,333,225,400,0,175,225,400,0,0,223,2,0,225,0,1820,1935,True,29,194,sebsi:1  marzouki:1  
26,7,6,178,2,583,308,700,0,392,308,700,0,0,301,3,4,308,0,1810,1840,True,112,189,sebsi:1  marzouki:1  
26,7,6,178,1,583,387,700,0,313,387,700,0,0,378,6,3,387,0,1806,1850,True,200,178,sebsi:1  marzouki:1  
26,7,5,177,1,410,317,500,0,183,317,500,0,0,314,3,0,317,0,1820,1845,True,18,296,sebsi:1  marzouki:1  
26,7,5,176,1,318,201,400,0,199,201,400,0,0,199,2,0,201,0,1800,1845,True,34,165,sebsi:1  marzouki:1  
26,7,5,174,1,460,306,503,0,197,306,503,0,0,301,3,2,306,0,1815,1910,True,30,271,sebsi:1  marzouki:1  
26,7,4,173,1,500,355,600,0,245,355,600,0,0,351,2,2,355,0,1814,,True,52,299,sebsi:1  marzouki:1  
26,7,3,172,1,27,15,100,0,85,15,100,0,0,15,0,0,15,0,1800,1830,True,2,13,sebsi:1  marzouki:1  
26,7,3,171,1,163,121,200,0,79,121,200,0,0,117,1,3,121,0,1800,1830,True,16,101,sebsi:1  marzouki:1  
26,7,3,169,1,190,116,300,0,184,116,300,0,0,114,1,1,116,0,1815,1838,True,10,104,sebsi:1  marzouki:1  
26,7,2,168,1,74,39,100,0,61,39,100,0,0,39,0,0,39,0,1805,1825,True,7,32,sebsi:1  marzouki:1  
26,7,2,167,1,507,280,600,1,319,280,600,0,0,278,1,1,280,0,1800,1900,True,13,265,sebsi:1  marzouki:1  
26,7,1,166,1,224,135,300,0,165,135,300,0,0,135,0,0,135,0,1800,1830,True,37,98,sebsi:1  marzouki:1  
26,7,1,165,1,452,259,500,2,239,259,500,0,0,257,2,0,259,0,1807,1840,True,26,231,sebsi:1  marzouki:1  
26,7,1,164,3,445,241,500,1,258,241,500,0,0,240,0,1,241,0,1815,1838,True,29,211,sebsi:1  marzouki:1  
26,7,1,164,2,446,271,500,0,229,271,500,0,0,269,2,0,271,0,1810,1845,True,29,240,sebsi:1  marzouki:1  
26,7,1,164,1,446,305,504,0,199,305,504,0,0,297,5,3,305,0,1817,1909,True,69,228,sebsi:1  marzouki:1  
26,8,10,226,1,309,233,400,0,167,233,400,0,0,227,5,1,233,0,1815,1835,True,37,190,sebsi:1  marzouki:1  
26,8,10,225,1,251,202,304,0,102,202,304,0,0,201,1,0,202,0,1810,1830,True,16,185,sebsi:1  marzouki:1  
26,8,10,224,1,219,151,300,0,149,151,300,0,0,148,2,1,151,0,1818,1847,True,10,138,sebsi:1  marzouki:1  
26,8,10,223,1,453,323,500,28,149,323,500,0,0,316,7,0,323,0,1820,1910,True,21,295,sebsi:1  marzouki:1  
26,8,10,222,1,218,146,300,0,154,146,300,0,0,142,203,1,146,0,1810,1830,True,23,119,sebsi:1  marzouki:1  
26,8,10,221,1,350,264,400,0,136,264,400,0,0,262,1,1,264,0,1810,1845,True,38,224,sebsi:1  marzouki:1  
26,8,10,220,1,120,86,200,0,114,86,200,0,0,85,1,0,86,0,1815,1900,True,12,73,sebsi:1  marzouki:1  
26,8,10,219,1,260,178,300,0,122,178,300,0,0,177,1,0,178,0,1810,1830,True,34,143,sebsi:1  marzouki:1  
26,8,10,218,1,430,322,500,2,176,322,500,0,0,313,8,1,322,0,1825,1910,True,62,251,sebsi:1  marzouki:1  
26,8,9,217,1,278,206,300,0,94,206,300,0,0,204,1,1,206,0,1830,1850,True,13,191,sebsi:1  marzouki:1  
26,8,9,216,2,534,350,600,1,249,350,600,0,0,347,2,1,350,0,1830,1930,True,16,331,sebsi:1  marzouki:1  
26,8,9,216,1,535,452,600,0,148,452,600,0,0,438,11,3,452,0,1825,2005,True,35,403,sebsi:1  marzouki:1  
26,8,8,215,1,564,410,600,3,187,410,600,0,0,406,4,0,410,0,1800,1905,True,12,394,sebsi:1  marzouki:1  
26,8,7,214,1,109,76,200,0,124,76,200,0,0,76,0,0,76,0,1800,1843,True,5,71,sebsi:1  marzouki:1  
26,8,7,213,1,213,157,300,0,143,157,300,0,0,151,3,3,157,0,1830,1915,True,11,140,sebsi:1  marzouki:1  
26,8,7,212,1,113,82,200,0,118,82,200,0,0,81,1,0,82,0,1800,1830,True,13,68,sebsi:1  marzouki:1  
26,8,7,211,2,382,214,500,0,286,241,500,0,0,212,0,2,214,0,1837,1914,True,4,208,sebsi:1  marzouki:1  
26,8,7,211,1,383,273,500,1,226,273,500,0,0,271,2,0,273,0,1840,1933,True,15,256,sebsi:1  marzouki:1  
26,8,7,210,4,454,290,500,0,210,290,500,0,0,288,2,0,290,0,1800,1850,True,12,276,sebsi:1  marzouki:1  
26,8,7,210,3,457,301,500,0,199,301,500,0,0,300,0,1,301,0,1820,1915,True,15,285,sebsi:1  marzouki:1  
26,8,7,210,2,457,355,500,1,144,355,500,0,0,344,7,4,355,0,1828,1930,True,31,313,sebsi:1  marzouki:1  
26,8,7,210,1,457,338,500,1,161,338,500,0,0,330,6,2,338,0,1812,1854,True,41,289,sebsi:1  marzouki:1  
26,8,6,209,1,458,322,500,0,178,322,500,0,0,319,3,0,322,0,1805,1845,True,36,283,sebsi:1  marzouki:1  
26,8,6,208,1,520,379,600,1,220,379,600,0,0,376,1,2,379,0,1820,1925,True,21,355,sebsi:1  marzouki:1  
26,8,5,207,2,492,351,600,0,249,351,600,0,0,348,2,1,351,0,1815,1919,True,8,340,sebsi:1  marzouki:1  :  
26,8,5,207,1,492,363,600,6,231,363,600,0,0,354,5,4,363,0,1815,1910,True,22,332,sebsi:1  marzouki:1  
26,8,4,206,1,102,70,200,1,129,70,200,0,0,70,0,0,70,0,1815,1836,True,7,63,sebsi:1  marzouki:1  
26,8,4,205,1,198,137,300,0,163,137,300,0,0,135,0,2,137,0,,1900,True,6,129,sebsi:1  marzouki:1  
26,8,4,204,1,98,82,200,0,118,82,200,0,0,82,0,0,82,0,1822,1855,True,4,78,sebsi:1  marzouki:1  
26,8,4,203,1,84,68,100,0,32,68,100,0,0,67,0,1,68,0,,18022,True,3,64,sebsi:1  marzouki:1  
26,8,3,202,1,261,215,300,0,85,215,300,0,0,215,0,0,215,0,1800,,True,12,203,sebsi:1  marzouki:1  
26,8,3,201,1,549,397,600,0,203,397,600,0,0,390,3,4,397,0,1800,1910,True,25,365,sebsi:1  marzouki:1  
26,8,3,200,1,305,215,400,0,185,215,400,0,0,214,1,0,215,0,1800,1830,True,17,197,sebsi:1  marzouki:1  
26,8,3,199,2,433,299,500,1,200,299,500,0,0,296,2,1,299,0,1800,1915,True,13,283,sebsi:1  marzouki:1  
26,8,3,199,1,433,345,502,0,157,345,502,0,0,343,1,1,345,0,1810,1855,True,39,304,sebsi:1  marzouki:1  
26,8,2,198,2,428,296,500,0,204,296,500,0,0,290,4,2,296,0,1815,1900,True,25,265,sebsi:1  marzouki:1  
26,8,2,198,1,429,342,500,0,158,342,500,0,0,336,2,4,342,0,,1910,True,59,277,sebsi:1  marzouki:1  
26,8,1,197,4,497,329,600,0,271,329,600,0,0,324,4,1,329,0,1815,1855,True,23,301,sebsi:1  marzouki:1  
26,8,1,197,3,469,313,600,1,286,313,600,0,0,310,2,1,313,0,1815,1855,True,18,292,sebsi:1  marzouki:1  
26,8,1,197,2,469,371,600,0,229,371,600,0,0,368,2,1,371,0,1820,1855,True,29,339,sebsi:1  marzouki:1  
26,8,1,197,1,469,378,500,0,122,378,500,0,0,372,5,1,378,0,1806,1842,True,36,336,sebsi:1  marzouki:1  
26,8,1,196,4,501,317,600,0,283,317,600,0,0,313,2,2,317,0,1810,1846,True,22,291,sebsi:1  marzouki:1  
26,8,1,196,3,502,343,600,0,257,343,600,0,0,338,2,3,343,0,1812,1918,True,48,290,sebsi:1  marzouki:1  
26,8,1,196,2,502,378,600,0,222,378,600,0,0,371,5,2,378,0,1810,1905,True,54,317,sebsi:1  marzouki:1  
26,8,1,196,1,502,396,600,0,204,396,600,0,0,392,2,2,396,0,1800,1910,True,74,318,sebsi:1  marzouki:1  
26,8,1,195,3,558,360,598,0,238,360,598,0,0,350,8,2,360,0,1810,1900,True,25,325,sebsi:1  marzouki:1  
26,8,1,195,2,552,416,600,2,182,416,600,0,0,414,1,1,416,0,1820,1900,True,36,378,sebsi:1  marzouki:1  
26,8,1,195,1,559,420,600,180,420,420,600,0,0,410,3,7,420,0,1817,1932,True,64,346,sebsi:1  marzouki:1  
26,8,1,194,4,465,328,600,0,272,328,600,0,0,318,5,5,328,0,1805,1920,True,24,294,sebsi:1  marzouki:1  
26,8,1,194,3,465,356,600,1,243,356,600,0,0,352,1,3,356,0,1822,1920,True,49,303,sebsi:1  marzouki:1  
26,8,1,194,2,465,378,600,2,220,378,600,0,0,377,0,1,378,0,1825,1919,True,60,317,sebsi:1  marzouki:1  
26,8,1,194,1,465,364,600,0,236,364,600,0,0,357,6,1,364,0,1810,1905,True,80,277,sebsi:1  marzouki:1  
26,8,1,193,5,491,312,600,0,288,312,600,0,0,304,5,3,312,0,1800,1915,True,27,277,sebsi:1  marzouki:1  
26,8,1,193,4,492,333,603,0,270,333,603,0,0,326,4,3,333,0,1825,1933,True,32,294,sebsi:1  marzouki:1  
26,8,1,193,3,492,356,600,1,243,356,600,0,0,351,1,4,356,0,1820,1920,True,38,313,sebsi:1  marzouki:1  
26,8,1,193,2,492,384,600,0,216,384,600,0,0,375,5,4,384,0,1800,1900,True,67,308,sebsi:1  marzouki:1  
26,8,1,193,1,492,367,600,0,238,367,600,0,0,363,2,2,367,0,1840,1910,True,85,278,sebsi:1  marzouki:1  
26,8,1,192,4,570,364,700,0,337,363,700,0,1,363,0,0,363,0,1830,1915,True,49,314,sebsi:1  marzouki:1  
26,8,1,192,3,570,381,700,0,319,381,700,0,0,379,2,0,381,0,1815,1915,True,44,335,sebsi:1  marzouki:1  
26,8,1,192,2,570,451,700,2,247,451,700,0,0,446,4,1,451,0,1820,1935,True,65,381,sebsi:1  marzouki:1  
26,8,1,192,1,570,451,700,0,249,451,700,0,0,443,3,5,451,0,1815,1930,True,98,345,sebsi:1  marzouki:1  
26,9,7,247,1,136,104,200,0,96,104,200,0,0,102,0,2,104,0,1820,1850,True,3,99,sebsi:1  marzouki:1  
26,9,7,246,1,25,22,99,0,77,22,99,0,0,22,0,0,22,0,1820,,True,0,22,sebsi:1  marzouki:1  
26,9,7,245,1,57,37,100,0,63,37,100,0,0,37,0,0,37,0,1805,1815,True,0,37,sebsi:1  marzouki:1  
26,9,7,244,1,239,148,305,0,157,148,305,0,0,148,0,0,148,0,1815,1836,True,17,131,sebsi:1  marzouki:1  
26,9,6,243,1,67,45,100,0,55,45,100,0,0,44,0,1,45,0,1815,1830,True,2,42,sebsi:1  marzouki:1  
26,9,6,242,1,422,319,500,0,181,319,500,0,0,317,1,1,319,0,1800,1900,True,26,291,sebsi:1  marzouki:1  
26,9,5,241,1,187,145,300,1,154,145,300,0,0,144,1,0,145,0,1800,1845,True,22,122,sebsi:1  marzouki:1  
26,9,5,240,1,147,98,200,0,102,98,200,0,0,98,0,0,98,0,,1833,True,19,79,sebsi:1  marzouki:1  
26,9,5,239,2,505,297,600,0,303,297,600,0,0,289,5,3,297,0,1805,1903,True,23,266,sebsi:1  marzouki:1  
26,9,5,239,1,506,378,600,0,222,378,600,0,0,362,14,2,378,0,1813,1903,True,53,309,sebsi:1  marzouki:1  
26,9,4,238,1,258,173,300,0,127,173,300,0,0,171,0,2,173,0,1810,1835,True,13,158,sebsi:1  marzouki:1  
26,9,4,237,3,449,303,500,0,197,303,500,0,0,298,1,4,303,0,,,True,22,276,sebsi:1  marzouki:1  
26,9,4,237,2,450,343,500,0,157,343,500,0,0,340,3,0,343,0,1800,1800,True,35,305,sebsi:1  marzouki:1  
26,9,4,237,1,450,362,500,1,137,362,500,0,0,347,13,2,362,0,1820,1946,True,45,302,sebsi:1  marzouki:1  
26,9,4,236,1,542,366,600,2,232,366,600,0,0,366,0,0,366,0,1815,1930,True,24,342,sebsi:1  marzouki:1  
26,9,4,235,3,596,404,700,0,296,404,700,0,0,401,1,2,404,0,1805,1900,True,30,371,sebsi:1  marzouki:1  
26,9,4,235,2,597,460,700,0,240,460,700,0,0,458,1,1,460,0,1830,1900,True,43,415,sebsi:1  marzouki:1  
26,9,4,235,1,597,467,700,0,233,467,700,0,0,458,2,7,467,0,1810,1915,True,62,396,sebsi:1  marzouki:1  
26,9,4,234,4,507,317,600,0,283,317,600,0,0,312,3,2,317,0,1808,1900,True,10,302,sebsi:1  marzouki:1  
26,9,4,234,3,509,337,600,0,263,337,600,0,0,337,0,0,337,0,1820,1855,True,20,317,sebsi:1  marzouki:1  
26,9,4,234,2,509,394,600,2,204,394,600,0,0,392,1,1,394,0,1800,,True,32,360,sebsi:1  marzouki:1  
26,9,4,234,1,509,379,600,0,221,379,600,0,0,377,2,0,379,0,1800,1855,True,42,335,sebsi:1  marzouki:1  
26,9,4,233,3,406,237,500,0,263,237,500,0,0,235,1,1,237,0,1820,1850,True,22,213,sebsi:1  marzouki:1  
26,9,4,233,2,408,279,500,0,221,279,500,0,0,275,3,1,279,0,1810,1854,True,35,240,sebsi:1  marzouki:1  
26,9,4,233,1,408,301,500,1,198,301,500,0,0,293,7,1,301,0,1815,1856,True,53,240,sebsi:1  marzouki:1  
26,9,4,232,7,551,332,600,0,268,332,600,0,0,331,0,1,332,0,1815,195,True,36,295,sebsi:1  marzouki:1  
26,9,4,232,6,553,334,600,0,266,334,600,0,0,333,1,0,334,0,1820,1930,True,23,310,sebsi:1  marzouki:1  
26,9,4,232,5,553,358,600,1,241,358,600,0,0,352,3,3,358,0,1830,1937,True,31,321,sebsi:1  marzouki:1  
26,9,4,232,4,553,386,600,2,212,386,600,0,0,385,0,1,386,0,1830,1955,True,28,357,sebsi:1  marzouki:1  
26,9,4,232,3,553,410,600,0,190,410,600,0,0,396,13,1,410,0,1800,1922,True,45,351,sebsi:1  marzouki:1  
26,9,4,232,2,553,415,600,0,185,415,600,0,0,409,6,0,415,0,1820,1913,True,56,353,sebsi:1  marzouki:1  
26,9,4,232,1,553,423,600,1,176,423,600,0,0,414,8,1,423,0,1815,1925,True,87,327,sebsi:1  marzouki:1  
26,9,4,231,1,408,306,500,2,192,306,500,0,0,297,7,2,306,0,1800,2010,True,80,217,sebsi:1  marzouki:1  
26,9,4,230,5,510,318,599,0,282,317,599,0,1,304,8,5,317,0,1805,1904,True,37,267,sebsi:1  marzouki:1  
26,9,4,230,4,511,298,600,0,302,298,600,0,0,294,2,2,298,0,1820,1855,True,40,254,sebsi:1  marzouki:1  
26,9,4,230,3,511,363,600,1,236,363,600,0,0,359,0,4,363,0,1800,19100,True,49,310,sebsi:1  marzouki:1  
26,9,4,230,2,511,363,600,0,237,363,600,0,0,353,8,2,363,0,1820,1900,True,82,271,sebsi:1  marzouki:1  
26,9,4,230,1,511,361,600,2,237,361,600,0,0,354,3,4,361,0,1800,1800,True,90,264,sebsi:1  marzouki:1  
26,9,3,229,6,541,338,598,0,260,338,598,0,0,334,3,1,338,0,1815,2000,True,29,305,sebsi:1  marzouki:1  
26,9,3,229,5,541,323,598,0,275,323,598,0,0,319,2,2,323,0,1819,1930,True,23,296,sebsi:1  marzouki:1  
26,9,3,229,4,541,379,600,0,221,379,600,0,0,373,4,2,379,0,1825,1930,True,31,342,sebsi:1  marzouki:1  
26,9,3,229,3,541,398,600,1,201,398,600,0,0,394,1,3,398,0,1830,1920,True,54,340,sebsi:1  marzouki:1  
26,9,3,229,2,541,410,600,1,189,410,600,0,0,405,2,3,410,0,1800,1902,True,66,339,sebsi:1  marzouki:1  
26,9,3,229,1,541,386,600,0,214,386,600,0,0,377,8,1,386,0,1825,1930,True,69,308,sebsi:1  marzouki:1  
26,9,2,228,1,307,224,400,0,176,224,400,0,0,219,5,0,224,0,1812,1910,True,23,196,sebsi:1  marzouki:1  
26,9,1,227,1,331,287,400,1,112,287,400,0,0,281,3,3,287,0,,1857,True,4,277,sebsi:1  marzouki:1  
26,5,7,127,2,478,301,600,0,299,301,600,0,0,297,3,1,301,0,1800,1900,True,30,267,sebsi:1  marzouki:1  
26,5,7,127,1,478,345,600,0,255,345,600,0,0,336,5,4,345,0,1813,1855,True,51,285,sebsi:1  marzouki:1  
26,5,6,126,1,197,118,300,0,182,118,300,0,0,118,0,0,118,0,1800,1840,True,10,108,sebsi:1  marzouki:1  
26,5,6,125,2,308,221,400,0,179,221,400,0,0,219,0,2,221,0,1810,1845,True,8,211,sebsi:1  marzouki:1  
26,5,6,125,1,308,236,400,2,162,236,400,0,0,233,1,2,236,0,1815,1900,True,18,215,sebsi:1  marzouki:1  
26,5,6,123,4,513,294,600,0,306,294,600,0,0,292,2,0,294,0,1815,1845,True,21,271,sebsi:1  marzouki:1  
26,5,6,123,3,515,329,600,0,271,329,600,0,0,327,1,1,329,0,1825,1855,True,31,296,sebsi:1  marzouki:1  
26,5,6,123,2,515,371,600,1,228,371,600,0,0,366,4,1,371,0,1800,1906,True,53,313,sebsi:1  marzouki:1  
26,5,6,123,1,515,338,600,0,262,338,600,0,0,336,2,0,338,0,,1900,True,52,284,sebsi:1  marzouki:1  
26,5,5,122,1,485,308,592,0,284,308,592,0,0,305,1,2,308,0,1830,1935,True,23,282,sebsi:1  marzouki:1  
26,5,5,121,1,183,103,304,0,201,103,304,0,0,102,1,0,103,0,1811,1851,True,18,84,sebsi:1  marzouki:1  
26,5,5,120,1,265,173,300,0,128,172,300,0,0,167,3,2,172,0,1815,1900,True,15,152,sebsi:1  marzouki:1  
26,5,5,119,3,500,326,600,0,274,326,600,0,0,325,1,0,326,0,1800,1905,True,21,304,sebsi:1  marzouki:1  
26,5,5,119,2,502,367,601,0,234,367,601,0,0,365,1,1,367,0,1800,1900,True,25,340,sebsi:1  marzouki:1  
26,5,5,119,1,502,326,600,0,274,326,600,0,0,315,10,1,326,0,,1905,True,33,282,sebsi:1  marzouki:1  
26,5,4,118,1,166,96,200,0,104,96,200,0,0,94,2,0,96,0,1810,1845,True,30,64,sebsi:1  marzouki:1  
26,5,4,117,3,428,251,500,1,248,251,500,0,0,244,6,1,251,0,1800,1928,True,27,217,sebsi:1  marzouki:1  
26,5,4,117,2,428,279,500,0,221,279,500,0,0,272,3,4,279,0,1820,1909,True,61,211,sebsi:1  marzouki:1  
26,5,4,117,1,428,258,500,0,242,258,500,0,0,244,10,4,258,0,1820,1910,True,63,181,sebsi:1  marzouki:1  
26,5,3,116,1,455,310,500,1,189,310,500,0,0,306,4,0,310,0,1805,1900,True,54,252,sebsi:1  marzouki:1  
26,5,3,115,4,490,264,600,0,336,264,600,0,0,261,2,1,264,0,1815,1920,True,32,229,sebsi:1  marzouki:1  
26,5,3,115,3,492,308,600,0,292,308,600,0,0,299,7,2,308,0,1820,1930,False,41,258,sebsi:1  marzouki:1  
26,5,3,115,1,492,334,600,0,266,334,600,0,0,332,1,1,334,0,1810,1930,True,113,219,sebsi:1  marzouki:1  
26,5,2,114,1,452,302,500,0,198,302,500,0,0,298,2,2,302,0,827,1934,True,57,241,sebsi:1  marzouki:1  
26,5,2,113,3,452,226,500,0,274,226,500,0,0,222,1,3,226,0,1820,1930,True,37,185,sebsi:1  marzouki:1  
26,5,2,113,2,453,273,503,0,230,273,503,0,0,268,2,3,273,0,1830,1840,True,65,203,sebsi:1  marzouki:1  
26,5,2,113,1,453,297,500,0,203,297,500,0,0,291,3,3,297,0,1810,1850,True,103,188,sebsi:1  marzouki:1  
26,5,1,112,2,458,247,500,0,253,247,500,0,0,245,0,2,247,0,1815,1845,True,60,185,sebsi:1  marzouki:1  
26,5,1,112,1,458,289,500,0,211,289,500,0,0,284,4,1,289,0,1820,1905,True,116,168,sebsi:1  marzouki:1  
26,5,1,111,4,578,291,700,0,409,291,700,0,0,286,4,1,291,0,1830,1915,True,49,237,sebsi:1  marzouki:1  
26,5,1,111,3,578,301,700,0,399,301,700,0,0,297,0,4,301,0,1820,1910,False,92,205,sebsi:1  marzouki:1  
26,5,1,111,2,578,351,700,0,349,351,700,0,0,347,0,4,351,0,810,1855,True,59,288,sebsi:1  marzouki:1  
26,5,1,110,2,575,323,698,0,375,323,698,0,0,317,3,3,323,0,1820,1916,True,45,272,sebsi:1  marzouki:1  
26,5,1,109,2,351,211,400,0,189,211,400,0,0,211,0,0,211,0,1815,1845,True,39,172,sebsi:1  marzouki:1  
26,5,1,109,1,351,232,400,0,168,232,400,0,0,229,3,0,232,0,1820,,True,80,149,sebsi:1  marzouki:1  
26,5,1,108,2,436,260,500,0,240,260,500,0,0,260,0,0,260,0,1815,,True,45,215,sebsi:1  marzouki:1  
26,5,1,108,1,436,275,500,2,223,275,500,0,0,267,3,5,275,0,1813,1855,True,80,187,sebsi:1  marzouki:1  
26,5,1,107,8,533,304,600,0,296,304,600,0,0,300,3,1,304,0,2018,1855,True,77,223,sebsi:1  marzouki:1  
26,5,1,107,7,537,297,600,0,303,297,600,0,0,295,2,0,297,0,1818,1906,True,55,240,sebsi:1  marzouki:1  
26,5,1,107,6,537,268,600,0,332,268,600,0,0,265,2,1,268,0,1815,1855,True,109,156,sebsi:1  marzouki:1  
26,5,1,107,4,537,390,600,0,210,390,600,0,0,384,3,3,390,0,1815,1850,True,88,296,sebsi:1  marzouki:1  
26,5,1,107,3,537,388,600,0,212,388,600,0,0,380,3,5,388,0,1815,1843,True,112,268,sebsi:1  marzouki:1  
26,5,1,107,2,537,382,600,1,217,382,600,0,0,372,5,5,382,0,1830,1930,True,120,252,sebsi:1  marzouki:1  
26,5,1,107,1,537,369,600,1,230,369,600,0,0,364,1,4,369,0,1845,1925,True,150,214,sebsi:1  marzouki:1  
26,4,11,106,1,420,279,500,1,220,279,500,0,0,273,1,5,279,0,1800,1915,True,45,228,sebsi:1  marzouki:1  
26,4,11,105,1,371,245,500,0,255,245,500,0,0,241,2,2,245,0,1815,1850,True,16,225,sebsi:1  marzouki:1  
26,4,11,104,5,483,329,600,0,271,329,600,0,0,329,0,0,329,0,1815,,True,22,307,sebsi:1  marzouki:1  
26,4,11,104,4,485,318,600,0,282,318,600,0,0,314,3,1,318,0,1815,,True,36,278,sebsi:1  marzouki:1  
26,4,11,104,3,485,359,600,0,241,359,600,0,0,351,6,2,359,0,1810,1900,True,39,312,sebsi:1  marzouki:1  
26,4,11,104,2,485,385,600,0,215,385,600,0,0,379,5,1,6,0,1830,,True,73,306,sebsi:1  marzouki:1  
26,4,11,104,1,485,334,600,0,266,334,600,0,0,329,2,3,334,0,,1900,True,90,239,sebsi:1  marzouki:1  
26,4,10,103,3,477,326,600,0,274,326,600,0,0,324,0,2,326,0,1810,1900,True,59,265,sebsi:1  marzouki:1  
26,4,10,103,2,479,369,600,3,228,369,600,0,0,368,0,1,369,0,1805,1845,True,95,273,sebsi:1  marzouki:1  
26,4,10,103,1,479,350,600,0,250,350,600,0,0,344,6,0,350,0,1815,1850,True,110,234,sebsi:1  marzouki:1  
26,4,9,102,2,408,255,500,0,245,255,500,0,0,252,2,1,255,0,1800,1845,True,23,229,sebsi:1  marzouki:1  
26,4,9,102,1,408,258,500,2,240,258,500,0,0,254,1,3,258,0,1810,1852,True,46,208,sebsi:1  marzouki:1  
26,4,9,101,1,534,370,602,0,232,370,602,0,0,368,2,0,370,0,1815,1900,True,40,328,sebsi:1  marzouki:1  
26,4,9,100,1,378,250,500,0,250,250,500,0,0,248,1,1,250,0,1815,1900,True,22,226,sebsi:1  marzouki:1  
26,4,9,99,1,393,279,500,1,220,279,500,0,0,278,0,1,279,0,1830,1920,True,26,252,sebsi:1  marzouki:1  
26,4,9,98,2,491,290,600,0,310,290,600,0,0,287,2,1,290,0,1805,1900,True,35,252,sebsi:1  marzouki:1  
26,4,9,98,1,492,330,600,0,270,330,600,0,0,322,5,3,330,0,1800,1900,True,75,247,sebsi:1  marzouki:1  
26,4,9,97,2,493,347,600,0,253,347,600,0,0,346,1,0,347,0,1815,1900,True,65,281,sebsi:1  marzouki:1  
26,4,9,97,1,493,322,600,1,277,322,600,0,0,318,4,0,322,0,,,True,80,238,sebsi:1  marzouki:1  
26,4,8,96,1,480,325,600,0,275,325,600,0,0,318,1,6,325,0,1820,1905,True,77,241,sebsi:1  marzouki:1  
26,4,8,95,4,485,269,600,0,331,269,600,0,0,266,1,2,269,0,1814,1905,True,84,128,sebsi:1  marzouki:1  
26,4,8,95,3,488,273,600,1,326,273,600,0,0,269,3,1,273,0,1804,1900,True,75,194,sebsi:1  marzouki:1  
26,4,8,95,2,488,358,601,0,243,358,601,0,0,353,2,3,358,0,1818,1910,True,112,241,sebsi:1  marzouki:1  
26,4,8,95,1,488,325,600,0,275,325,600,0,0,320,2,3,325,0,,1915,True,133,187,sebsi:1  marzouki:1  
26,4,7,94,1,467,330,500,1,169,330,500,0,0,326,3,1,330,0,,1930,True,35,291,sebsi:1  marzouki:1  
26,4,6,93,1,403,297,500,0,203,297,500,0,0,294,2,1,297,0,1820,1935,True,27,267,sebsi:1  marzouki:1  
26,4,6,92,2,361,209,400,0,191,209,400,0,0,206,1,2,209,0,1800,1930,True,27,179,sebsi:1  marzouki:1  
26,4,6,92,1,362,234,400,0,166,234,400,0,0,227,3,4,234,0,1830,1930,True,66,161,sebsi:1  marzouki:1  
26,4,6,91,2,417,284,500,2,214,284,500,0,0,279,2,3,284,0,,1905,True,17,262,sebsi:1  marzouki:1  
26,4,6,91,1,418,296,500,0,204,296,500,0,0,289,4,3,296,0,1830,1900,True,38,251,sebsi:1  marzouki:1  
26,4,5,90,2,579,388,700,0,312,388,700,0,0,387,1,0,388,0,125,1935,True,39,348,sebsi:1  marzouki:1  
26,4,5,90,1,579,421,700,3,276,421,700,0,0,416,3,2,421,0,1835,2000,True,95,321,sebsi:1  marzouki:1  
26,4,5,89,2,560,387,700,0,313,387,700,0,0,386,0,1,387,0,1825,1926,True,48,338,sebsi:1  marzouki:1  
26,4,5,89,1,560,411,700,0,289,411,700,0,0,407,0,4,411,0,1817,1915,True,82,325,sebsi:1  marzouki:1  
26,4,4,88,2,458,282,500,0,218,282,500,0,0,279,2,1,282,0,1813,1913,True,69,210,sebsi:1  marzouki:1  
26,4,4,88,1,458,336,500,0,164,336,500,0,0,327,9,0,336,0,1815,1907,True,120,207,sebsi:1  marzouki:1  
26,4,4,87,2,452,283,500,1,216,283,500,0,0,281,0,2,283,0,1815,1910,True,35,246,sebsi:1  marzouki:1  
26,4,4,87,1,453,309,500,0,191,309,500,0,0,298,0,5,309,0,1805,1900,True,82,216,sebsi:1  marzouki:1  
26,4,3,86,4,537,324,600,0,276,324,600,0,0,316,6,2,324,0,1810,1915,False,77,239,sebsi:1  marzouki:1  
26,4,3,86,3,539,333,600,1,266,333,600,0,0,327,5,1,333,0,1815,1909,True,75,252,sebsi:1  marzouki:1  
26,4,3,86,2,539,391,600,2,207,391,600,0,0,380,5,6,391,0,1822,1907,True,122,258,sebsi:1  marzouki:1  
26,4,3,85,8,548,367,600,0,233,367,600,0,0,350,14,3,367,0,1815,1915,True,89,261,sebsi:1  marzouki:1  
26,4,3,85,7,551,347,600,0,253,347,600,0,0,338,5,4,347,0,,1915,True,92,246,sebsi:1  marzouki:1  
26,4,3,85,6,551,353,600,0,247,353,600,0,0,349,2,2,353,0,1820,1916,True,100,249,sebsi:1  marzouki:1  
26,4,3,85,5,551,406,601,2,193,406,601,0,0,397,5,4,406,0,1835,1936,True,95,302,sebsi:1  marzouki:1  
26,4,3,85,4,551,394,600,1,205,394,600,0,0,387,2,5,394,0,1815,1926,True,134,253,sebsi:1  marzouki:1  
26,4,3,85,3,551,421,600,0,179,421,600,0,0,415,5,1,421,0,1822,1940,True,174,241,sebsi:1  marzouki:1  
26,4,3,85,2,551,404,600,0,196,404,600,0,0,400,2,2,404,0,1830,1915,True,159,241,sebsi:1  marzouki:1  
26,4,3,85,1,551,413,600,0,187,413,600,0,0,406,5,2,413,0,1800,1930,True,214,192,sebsi:1  marzouki:1  
26,4,2,84,3,597,346,700,0,354,346,700,0,0,340,3,3,346,0,1815,1900,True,61,279,sebsi:1  marzouki:1  
26,4,2,84,2,597,425,700,0,275,425,700,0,0,419,5,1,425,0,1830,1930,True,84,335,sebsi:1  marzouki:1  
26,4,2,84,1,597,439,700,2,259,439,700,0,0,428,8,3,439,0,1830,1905,True,124,304,sebsi:1  marzouki:1  
26,4,1,83,7,579,340,700,1,359,340,700,0,0,323,15,2,340,0,182,1910,True,136,187,sebsi:1  marzouki:1  
26,4,1,83,6,585,352,700,0,348,352,700,0,0,349,2,1,352,0,1806,1905,True,145,204,sebsi:1  marzouki:1  
26,4,1,83,5,585,400,700,0,300,400,700,0,0,392,4,4,400,0,1820,1910,True,136,256,sebsi:1  marzouki:1  
26,4,1,83,4,585,412,700,0,288,412,700,0,0,407,3,2,412,0,1815,1920,True,156,251,sebsi:1  marzouki:1  
26,4,1,83,3,585,435,704,0,269,435,704,0,0,427,3,5,435,0,1805,1925,True,199,228,sebsi:1  marzouki:1  
26,4,1,83,2,585,402,700,3,296,401,700,0,1,398,1,2,401,0,1820,1920,True,208,190,sebsi:1  marzouki:1  
26,4,1,83,1,585,435,701,0,266,435,701,0,0,428,6,1,435,0,1810,1920,True,233,195,sebsi:1  marzouki:1  
26,3,6,82,2,470,263,600,0,364,236,600,0,0,232,3,1,236,0,1815,1845,True,53,179,sebsi:1  marzouki:1  
26,3,6,82,1,471,283,600,2,315,283,600,0,0,280,0,3,283,0,1810,1905,True,109,171,sebsi:1  marzouki:1  
26,3,5,81,1,405,263,500,0,237,263,500,0,0,260,3,0,263,0,1820,1900,True,35,225,sebsi:1  marzouki:1  
26,3,4,80,1,458,302,500,0,198,302,500,0,0,296,6,0,302,0,1810,1930,True,29,267,sebsi:1  marzouki:1  
26,3,4,78,3,523,308,600,0,292,308,600,0,0,305,3,0,308,0,1800,1919,True,25,280,sebsi:1  marzouki:1  
26,3,4,78,2,524,354,600,0,246,354,600,0,0,343,5,6,354,0,1800,1920,True,42,301,sebsi:1  marzouki:1  
26,3,4,78,1,524,317,600,2,281,317,600,0,0,308,6,3,317,0,1817,1913,True,56,252,sebsi:1  marzouki:1  
26,3,3,77,1,521,333,600,0,267,333,600,0,0,328,4,1,333,0,1810,1908,True,41,287,sebsi:1  marzouki:1  
26,3,2,76,1,399,259,500,0,241,259,500,0,0,253,5,1,259,0,1820,1850,True,35,218,sebsi:1  marzouki:1  
26,3,1,75,1,374,267,500,2,231,267,500,0,0,267,0,0,267,0,,1900,True,28,239,sebsi:1  marzouki:1  
26,3,1,74,1,420,267,600,0,233,267,500,0,0,262,4,1,267,0,1800,1900,True,37,225,sebsi:1  marzouki:1  
26,3,1,73,2,381,243,500,1,256,243,500,0,0,243,0,0,243,0,1805,1900,True,9,234,sebsi:1  marzouki:1  
26,3,1,73,1,382,240,500,1,259,240,500,0,0,237,2,1,240,0,1810,1855,True,29,208,sebsi:1  marzouki:1  
26,3,1,72,1,288,212,400,1,187,212,400,0,0,210,2,0,212,0,1820,1915,True,25,185,sebsi:1  marzouki:1  
26,3,1,71,4,495,270,600,0,330,270,600,0,0,267,3,0,270,0,1800,1855,True,26,241,sebsi:1  marzouki:1  
26,3,1,71,3,496,325,600,0,275,325,600,0,0,323,1,1,325,0,1815,1920,True,41,282,sebsi:1  marzouki:1  
26,3,1,71,2,496,346,600,0,254,346,600,0,0,338,3,5,346,0,1800,1930,True,62,276,sebsi:1  marzouki:1  
26,3,1,71,1,496,342,600,1,257,342,600,0,0,335,2,5,342,0,,,True,64,271,sebsi:1  marzouki:1  
26,2,13,70,1,146,118,200,0,82,118,200,0,0,117,1,0,118,0,1814,,True,6,111,sebsi:1  marzouki:1  
26,2,13,69,1,319,250,400,2,148,250,400,0,0,250,0,0,250,0,1825,1906,True,22,228,sebsi:1  marzouki:1  
26,2,13,68,1,206,148,300,1,151,148,300,0,0,146,0,2,148,0,1815,1850,True,23,123,sebsi:1  marzouki:1  
26,2,13,67,2,498,275,600,0,328,275,600,0,0,275,0,0,275,0,1825,1920,True,14,261,sebsi:1  marzouki:1  
26,2,13,67,1,499,306,600,0,294,306,600,0,0,299,2,5,306,0,1820,1922,True,59,240,sebsi:1  marzouki:1  
26,2,12,66,2,350,175,400,0,225,175,400,0,0,171,3,1,175,0,1820,1900,True,21,150,sebsi:1  marzouki:1  
26,2,12,66,1,351,224,400,4,172,224,400,0,0,219,2,3,224,0,1808,1909,True,62,157,sebsi:1  marzouki:1  
26,2,12,65,1,288,157,400,0,243,157,400,0,0,155,2,0,157,0,1820,1855,True,48,107,sebsi:1  marzouki:1  
26,2,11,64,2,448,250,495,0,245,250,495,0,0,248,2,0,250,0,1813,1844,True,40,208,sebsi:1  marzouki:1  
26,2,11,64,1,449,286,500,0,214,286,500,0,0,278,4,4,286,0,1800,1905,True,72,206,sebsi:1  marzouki:1  
26,2,11,63,1,393,220,498,0,278,220,498,0,0,210,8,2,220,0,1820,1905,True,62,148,sebsi:1  marzouki:1  
26,2,10,62,1,289,204,404,1,199,204,404,0,0,200,4,0,204,0,1815,1855,True,6,194,sebsi:1  marzouki:1  
26,2,10,61,1,144,87,202,0,115,87,202,0,0,81,4,2,87,0,,1820,True,8,73,sebsi:1  marzouki:1  
26,2,9,60,1,294,198,400,0,202,198,400,0,0,195,2,1,198,0,1816,1840,True,39,156,sebsi:1  marzouki:1  
26,2,9,59,1,187,133,200,0,67,133,200,0,0,123,4,6,133,0,1810,1838,True,12,111,sebsi:1  marzouki:1  
26,2,9,58,1,250,172,300,0,128,172,300,0,0,170,1,1,172,0,1830,1930,True,29,141,sebsi:1  marzouki:1  
26,2,8,57,2,443,275,500,0,225,275,500,0,0,273,2,0,275,0,1850,,True,10,263,sebsi:1  marzouki:1  
26,2,8,57,1,443,320,500,0,180,320,500,0,0,316,4,0,320,0,1815,1945,True,15,301,sebsi:1  marzouki:1  
26,2,7,56,1,94,65,100,0,35,65,100,0,0,64,0,1,65,0,1805,1825,True,3,61,sebsi:1  marzouki:1  
26,2,7,55,1,335,226,400,0,174,226,400,0,0,222,4,0,226,0,,,True,90,132,sebsi:1  marzouki:1  
26,2,7,54,1,195,147,300,0,153,147,300,0,0,146,1,0,147,0,1815,1850,True,17,129,sebsi:1  marzouki:1  
26,2,7,53,2,334,211,400,0,189,211,400,0,0,208,3,0,211,0,1830,1901,True,11,197,sebsi:1  marzouki:1  
26,2,7,53,1,335,225,400,1,175,224,400,0,1,221,3,0,224,0,1820,,True,30,191,sebsi:1  marzouki:1  
26,2,6,52,1,118,79,200,0,121,79,200,0,0,77,2,0,79,0,1810,1840,True,4,73,sebsi:1  marzouki:1  
26,2,6,51,1,245,171,300,0,129,171,300,0,0,166,3,2,171,0,1820,1857,True,6,160,sebsi:1  marzouki:1  
26,2,6,50,2,302,169,417,0,248,169,417,0,0,164,5,0,169,0,1815,1845,True,9,155,sebsi:1  marzouki:1  
26,2,6,50,1,303,191,400,0,209,191,400,0,0,186,5,0,191,0,,,True,23,163,sebsi:1  marzouki:1  
26,2,5,49,1,81,37,100,0,63,37,100,0,0,37,0,0,37,0,,,True,11,26,sebsi:1  marzouki:1  
26,2,5,48,1,339,178,400,2,220,178,400,0,0,174,2,2,178,0,,,True,23,151,sebsi:1  marzouki:1  
26,2,4,47,1,88,56,200,0,144,56,200,0,0,53,0,3,56,0,1815,1835,True,1,52,sebsi:1  marzouki:1  
26,2,4,46,1,538,273,600,1,326,273,600,0,0,271,1,1,273,0,1825,1854,True,32,239,sebsi:1  marzouki:1  
26,2,3,45,1,275,179,400,0,221,179,400,0,0,172,4,3,179,0,1818,1905,True,23,149,sebsi:1  marzouki:1  
26,2,2,44,1,188,122,200,0,78,122,200,0,0,122,0,0,122,0,1820,1845,True,14,108,sebsi:1  marzouki:1  
26,2,2,43,1,186,111,200,3,86,111,200,0,0,108,3,0,111,0,1830,1900,True,5,103,sebsi:1  marzouki:1  
26,2,1,42,1,147,107,200,0,93,107,200,0,0,104,2,1,107,0,1824,1900,True,15,89,sebsi:1  marzouki:1  
26,2,1,41,1,302,189,400,0,211,189,400,0,0,185,4,0,189,0,1815,1900,True,13,172,sebsi:1  marzouki:1  
26,2,1,40,3,455,244,502,1,257,244,502,0,0,240,3,1,244,0,1817,,True,27,213,sebsi:1  marzouki:1  
26,2,1,40,2,457,287,500,1,212,287,500,0,0,284,3,0,287,0,1818,1906,True,30,254,sebsi:1  marzouki:1  
26,2,1,40,1,457,302,492,0,190,302,492,0,0,297,4,1,302,0,1805,1846,True,52,245,sebsi:1  marzouki:1  
26,2,1,39,2,458,299,500,0,201,299,500,0,0,295,0,0,295,0,1810,1910,True,32,263,sebsi:1  marzouki:1  
26,2,1,39,1,458,312,500,1,187,312,500,0,0,307,4,1,312,0,1820,1900,True,58,249,sebsi:1  marzouki:1  
26,1,12,38,1,213,107,300,0,193,107,300,0,0,105,2,0,107,0,1815,1825,True,5,100,sebsi:1  marzouki:1  
26,1,12,37,1,248,159,300,0,141,159,300,0,0,157,2,0,159,0,1810,1845,True,28,129,sebsi:1  marzouki:1  
26,1,12,36,2,392,212,500,1,287,212,500,0,0,211,1,0,212,0,1820,1846,True,44,167,sebsi:1  marzouki:1  
26,1,12,36,1,393,277,500,0,223,277,500,0,0,273,3,1,277,0,1810,1850,True,68,205,sebsi:1  marzouki:1  
26,1,12,35,2,478,231,600,0,369,231,600,0,0,228,2,1,231,0,1810,1848,True,13,215,sebsi:1  marzouki:1  
26,1,11,34,1,151,80,200,0,120,80,200,0,0,76,2,2,80,0,1815,1900,True,21,55,sebsi:1  marzouki:1  
26,1,11,33,1,287,225,400,0,175,225,400,0,0,224,0,1,225,0,1800,1850,True,17,207,sebsi:1  marzouki:1  
26,1,11,32,1,173,147,200,0,53,147,200,0,0,139,5,3,147,0,1820,1925,True,9,130,sebsi:1  marzouki:1  
26,1,11,31,1,530,334,600,3,263,334,600,0,0,332,2,0,334,0,1830,1910,True,43,289,sebsi:1  marzouki:1  
26,1,10,30,1,358,254,400,0,146,251,400,0,0,251,2,1,254,0,1820,1905,True,27,224,sebsi:1  marzouki:1  
26,1,10,29,1,181,101,200,1,98,101,200,0,0,101,0,0,101,0,1800,1820,True,10,91,sebsi:1  marzouki:1  
26,1,9,28,1,129,71,200,0,129,71,200,0,0,70,1,0,71,0,1805,1830,True,6,64,sebsi:1  marzouki:1  
26,1,9,27,1,351,198,400,0,202,198,400,0,0,197,1,0,198,0,1810,1900,True,27,170,sebsi:1  marzouki:1  
26,1,9,26,2,514,347,600,0,253,347,600,0,0,346,1,0,347,0,1810,1844,True,20,326,sebsi:1  marzouki:1  
26,1,9,26,1,515,403,601,2,196,403,601,0,0,393,6,4,403,0,1800,1920,True,44,349,sebsi:1  marzouki:1  
26,1,9,25,3,430,208,500,0,292,208,500,0,0,206,0,2,208,0,1805,1850,True,11,195,sebsi:1  marzouki:1  
26,1,9,25,2,430,239,500,0,261,239,500,0,0,237,2,0,239,0,1800,1900,True,13,224,sebsi:1  marzouki:1  
26,1,9,25,1,430,272,500,0,228,272,500,0,0,267,4,1,272,0,1811,1900,True,50,217,sebsi:1  marzouki:1  
26,1,8,24,2,458,369,500,5,126,369,500,0,0,364,4,1,369,0,1830,2015,True,13,351,sebsi:1  marzouki:1  
26,1,8,24,1,459,358,500,0,142,358,500,0,0,349,8,1,358,0,1815,1937,True,41,308,sebsi:1  marzouki:1  
26,1,8,23,3,421,210,500,0,290,210,500,0,0,207,2,1,210,0,1818,1920,True,24,183,sebsi:1  marzouki:1  
26,1,8,23,2,422,266,502,2,234,266,502,0,0,260,5,1,266,0,1800,1909,True,22,238,sebsi:1  marzouki:1  
26,1,8,23,1,422,280,500,0,221,279,500,0,1,273,4,2,279,0,1800,1849,True,53,220,sebsi:1  marzouki:1  
26,1,7,22,1,499,311,600,0,289,311,600,0,0,310,1,0,311,0,1830,1908,True,31,279,sebsi:1  marzouki:1  
26,1,7,21,2,421,245,500,1,254,245,500,0,0,242,2,1,245,0,1815,1900,True,24,218,sebsi:1  marzouki:1  
26,1,7,21,1,421,280,500,0,220,280,500,0,0,271,9,0,280,0,1925,,True,38,233,sebsi:1  marzouki:1  
26,1,7,20,2,465,285,596,0,311,285,596,0,0,282,1,2,285,0,1815,1905,True,29,253,sebsi:1  marzouki:1  
26,1,7,20,1,465,329,600,0,271,329,600,0,0,320,7,2,329,0,1815,1900,True,66,254,sebsi:1  marzouki:1  
26,1,7,19,2,503,317,600,0,283,317,600,0,0,312,4,1,317,0,1810,1845,True,37,275,sebsi:1  marzouki:1  
26,1,7,19,1,503,358,600,1,241,358,600,0,0,353,4,1,358,0,1815,1900,True,81,272,sebsi:1  marzouki:1  
26,1,6,18,4,490,268,600,1,331,268,600,0,0,267,0,1,268,0,1810,1850,True,36,231,sebsi:1  marzouki:1  
26,1,6,18,3,492,274,600,0,326,274,600,0,0,272,2,0,274,0,1820,1900,True,33,239,sebsi:1  marzouki:1  
26,1,6,18,1,492,336,600,1,263,336,600,0,0,331,4,1,336,0,1825,1911,True,81,250,sebsi:1  marzouki:1  
26,1,6,17,2,312,128,400,0,272,128,400,0,0,128,0,0,128,0,1810,1835,True,44,84,sebsi:1  marzouki:1  
26,1,6,17,1,312,149,400,0,251,149,400,0,0,143,3,3,149,0,1810,1836,True,59,84,sebsi:1  marzouki:1  
26,1,5,16,1,346,200,400,0,200,200,400,0,0,199,1,0,200,0,1820,1910,True,18,181,sebsi:1  marzouki:1  
26,1,5,15,1,413,260,500,2,238,260,500,0,0,258,1,1,260,0,1825,1900,True,29,229,sebsi:1  marzouki:1  
26,1,5,14,3,536,253,609,0,356,253,609,0,0,250,3,0,253,0,1805,1911,True,37,213,sebsi:1  marzouki:1  
26,1,5,14,2,536,325,600,0,275,325,600,0,0,319,4,2,325,0,1815,1900,True,51,268,sebsi:1  marzouki:1  
26,1,5,14,1,536,346,600,0,254,346,600,0,0,340,4,2,346,0,1815,1930,True,95,245,sebsi:1  marzouki:1  
26,1,4,13,1,278,149,400,0,251,149,400,0,0,146,2,1,149,0,1810,1900,True,19,127,sebsi:1  marzouki:1  
26,1,4,12,1,378,230,500,0,270,230,500,0,0,227,3,0,230,0,1815,1900,True,30,197,sebsi:1  marzouki:1  
26,1,4,11,1,575,314,700,0,386,314,700,0,0,308,4,2,314,0,1820,1927,True,58,250,sebsi:1  marzouki:1  
26,1,4,10,2,541,284,600,0,316,284,600,0,0,280,4,0,284,0,1811,1900,True,45,235,sebsi:1  marzouki:1  
26,1,4,10,1,542,352,600,1,247,352,600,0,0,348,3,1,352,0,1820,1910,True,91,257,sebsi:1  marzouki:1  
26,1,3,9,2,312,156,383,0,227,156,383,0,0,153,2,1,156,0,1800,1840,True,15,138,sebsi:1  marzouki:1  
26,1,3,9,1,313,211,400,0,189,211,400,0,0,208,3,0,211,0,1800,1843,True,47,161,sebsi:1  marzouki:1  
26,1,3,8,2,442,269,500,0,231,269,500,0,0,267,1,1,269,0,1800,1840,True,22,245,sebsi:1  marzouki:1  
26,1,3,8,1,443,329,500,0,171,329,500,0,0,327,2,0,329,0,1815,1900,True,42,285,sebsi:1  marzouki:1  
26,1,3,7,2,492,233,600,1,366,233,600,0,0,232,0,1,233,0,1815,1855,True,15,217,sebsi:1  marzouki:1  
26,1,3,7,1,493,303,600,0,297,303,600,0,0,299,3,1,303,0,1815,,True,61,238,sebsi:1  marzouki:1  
26,1,2,6,1,228,153,300,1,146,153,300,0,0,152,0,1,153,0,1815,1845,True,27,125,sebsi:1  marzouki:1  
26,1,2,5,2,308,156,400,2,242,156,400,0,0,154,1,1,156,0,1815,1900,True,7,147,sebsi:1  marzouki:1  
26,1,2,5,1,308,227,400,0,173,227,400,0,0,226,1,0,227,0,1820,1850,True,37,189,sebsi:1  marzouki:1  
26,1,2,4,5,482,237,600,0,366,237,603,3,0,236,1,0,237,0,1850,,True,38,198,sebsi:1  marzouki:1  
26,1,2,4,4,485,287,596,0,309,287,596,0,0,284,3,0,287,0,1830,1910,True,42,242,sebsi:1  marzouki:1  
26,1,2,4,3,485,342,600,0,257,343,600,0,1,340,1,2,343,0,1830,1920,True,60,280,sebsi:1  marzouki:1  
26,1,2,4,2,485,328,600,0,272,328,600,0,0,323,4,1,328,0,1800,1900,True,97,226,sebsi:1  marzouki:1  
26,1,2,4,1,485,358,600,0,242,358,600,0,0,353,4,1,358,0,,1900,True,116,237,sebsi:1  marzouki:1  
26,1,1,3,1,103,67,200,0,133,67,200,0,0,67,0,0,67,0,1810,1840,True,11,56,sebsi:1  marzouki:1  
26,1,1,2,3,444,209,500,0,291,209,500,0,0,206,2,1,209,0,1820,1900,True,20,186,sebsi:1  marzouki:1  
26,1,1,2,2,446,273,500,0,227,273,500,0,0,270,2,1,273,0,1800,1843,True,43,227,sebsi:1  marzouki:1  
26,1,1,2,1,446,295,500,0,205,295,500,0,0,292,2,1,295,0,1835,1849,True,89,203,sebsi:1  marzouki:1  
26,1,1,1,3,578,306,700,0,394,306,700,0,0,300,4,2,306,0,1845,1935,True,65,235,sebsi:1  marzouki:1  
26,1,1,1,2,580,387,700,1,312,387,700,0,0,381,3,3,387,0,1815,1914,True,88,293,sebsi:1  marzouki:1  
26,1,1,1,1,580,441,697,0,256,441,697,0,0,430,6,5,441,0,1815,,True,136,294,sebsi:1  marzouki:1  
