circonscriptionId,delegationId,subDelegationId,centerID,stationId,registeredVoters,aSigningVoters,bDeliveredBallots,cSpoiledBallots,dLeftBallots,fExtractedBallots,gEplusF,hBminusG,iAminusF,jListVotes,kCancelledVotes,lBlankVotes,mJplusKplusL,nFminusM,countingStart,countingEnd,tampon,sebsi,marzouki,observers
3,9,8,96,3,470,279,500,0,221,279,500,0,0,271,6,2,279,0,1830,1913,True,128,143,sebsi:1  marzouki:1  
3,9,8,96,2,471,319,500,0,181,319,500,0,0,315,3,1,319,0,1820,1910,True,158,157,sebsi:1  marzouki:1  
3,9,8,96,1,471,358,500,0,142,358,500,0,0,350,5,3,358,0,1830,1930,True,196,154,sebsi:1  marzouki:1  
3,9,7,95,6,581,404,700,0,296,404,700,0,0,392,10,2,404,0,1815,1930,True,216,176,sebsi:1  marzouki:1  
3,9,7,95,5,581,437,702,0,265,437,702,0,0,427,5,5,437,0,1820,1940,True,225,202,sebsi:1  marzouki:1  
3,9,7,95,4,581,435,701,0,266,435,701,0,0,427,1,7,435,0,1830,1930,True,270,157,sebsi:1  marzouki:1  
3,9,7,95,3,581,451,700,0,249,451,700,0,0,444,4,3,451,0,1836,1947,True,262,182,sebsi:1  marzouki:1  
3,9,7,95,2,581,488,700,0,212,488,700,0,0,481,3,4,488,0,1810,2000,True,311,170,sebsi:1  marzouki:1  
3,9,7,95,1,581,510,699,3,186,510,699,0,0,498,9,3,510,0,1820,1936,True,364,134,sebsi:1  marzouki:1  
3,9,6,94,3,540,369,600,0,231,369,600,0,0,356,8,5,369,0,1822,2007,True,218,138,sebsi:1  marzouki:1  
3,9,6,94,2,541,399,600,0,201,399,600,0,0,393,3,3,399,0,1830,1945,True,234,159,sebsi:1  marzouki:1  
3,9,6,93,2,382,296,500,0,204,296,500,0,0,280,12,4,296,0,1820,1910,True,197,83,sebsi:1  marzouki:1  
3,9,6,93,1,383,332,500,0,168,332,500,0,0,321,8,3,332,0,1800,1915,True,259,62,sebsi:1  marzouki:1  
3,9,5,92,3,490,328,600,0,272,328,600,0,0,317,6,5,328,0,1837,1920,True,172,145,sebsi:1  marzouki:1  
3,9,5,92,1,490,403,600,0,197,403,600,0,0,389,9,5,403,0,1830,1930,True,298,91,sebsi:1  marzouki:1  
3,9,4,91,5,547,327,600,1,272,327,600,0,0,315,5,7,327,0,1830,,True,164,151,sebsi:1  marzouki:1  
3,9,4,91,4,547,351,600,0,249,351,600,0,0,347,4,0,351,0,1800,1920,False,206,141,sebsi:1  marzouki:1  
3,9,4,91,2,547,411,600,3,186,411,600,0,0,401,3,7,411,0,1830,1940,True,237,164,sebsi:1  marzouki:1  
3,9,4,91,1,547,418,600,0,182,418,600,0,0,409,6,3,418,0,1850,2015,False,266,143,sebsi:1  marzouki:1  
3,9,4,90,5,530,338,600,0,262,338,600,0,0,322,11,5,338,0,1810,2219,False,188,134,sebsi:1  marzouki:1  
3,9,4,90,4,534,377,600,1,222,377,600,0,0,371,4,2,377,0,1800,1920,True,211,160,sebsi:1  marzouki:1  
3,9,4,90,3,534,408,584,0,176,408,584,0,0,400,4,4,408,0,1816,1922,True,216,184,sebsi:1  marzouki:1  
3,9,4,89,2,555,428,600,1,171,428,600,0,0,419,4,5,428,0,,,True,250,169,sebsi:1  marzouki:1  
3,9,4,89,1,555,459,600,1,140,459,600,0,0,454,2,3,459,0,,1900,True,336,118,sebsi:1  marzouki:1  
3,9,3,88,8,527,287,600,0,313,287,600,0,0,276,6,5,287,0,1800,1900,True,142,134,sebsi:1  marzouki:1  
3,9,3,88,7,531,290,600,1,309,290,600,0,0,286,1,3,290,0,1810,1845,True,126,160,sebsi:1  marzouki:1  
3,9,3,88,6,531,333,602,0,269,333,602,0,0,329,4,0,333,0,,1900,True,141,188,sebsi:1  marzouki:1  
3,9,3,88,5,531,336,600,0,264,336,600,0,0,329,6,1,336,0,1815,1910,True,174,155,sebsi:1  marzouki:1  
3,9,3,88,4,531,355,600,1,245,354,600,0,1,347,6,1,354,0,1815,1900,True,174,173,sebsi:1  marzouki:1  
3,9,3,88,3,531,383,600,0,217,383,600,0,0,369,5,9,383,0,1820,1938,True,175,194,sebsi:1  marzouki:1  
3,9,3,88,2,531,385,600,1,214,385,600,0,0,372,13,0,385,0,1830,1845,True,232,140,sebsi:1  marzouki:1  
3,9,3,88,1,531,405,601,0,196,405,601,0,0,390,6,9,405,0,1810,1938,True,264,126,sebsi:1  marzouki:1  
3,9,2,87,3,506,275,600,0,325,275,600,0,0,269,4,2,275,0,1815,1904,True,152,117,sebsi:1  marzouki:1  
3,9,2,87,2,508,333,600,0,267,333,600,0,0,326,3,4,333,0,1800,1900,True,193,133,sebsi:1  marzouki:1  
3,9,1,84,6,552,325,599,0,274,325,599,0,0,312,7,6,325,0,1806,1930,True,185,127,sebsi:1  marzouki:1  
3,9,1,84,5,555,381,600,0,219,381,600,0,0,373,4,4,381,0,1825,1900,True,211,162,sebsi:1  marzouki:1  
3,9,1,84,4,555,396,600,1,202,397,600,0,1,389,4,4,397,0,1815,1950,True,226,163,sebsi:1  marzouki:1  
3,9,1,84,3,555,411,600,0,189,411,600,0,0,406,2,3,411,0,1815,1900,True,233,173,sebsi:1  marzouki:1  
3,9,1,84,2,555,435,601,2,164,435,601,0,0,424,7,4,435,0,1835,2040,True,283,141,sebsi:1  marzouki:1  
3,9,1,84,1,555,424,600,2,175,423,600,0,1,408,6,9,423,0,1900,2000,True,283,125,sebsi:1  marzouki:1  
3,3,5,34,4,517,336,600,1,263,336,600,0,0,322,7,7,336,0,1845,2000,True,166,156,sebsi:1  marzouki:1  
3,3,5,34,3,519,374,600,1,225,374,600,0,0,365,6,3,374,0,1845,2001,True,198,167,sebsi:1  marzouki:1  
3,3,5,34,2,519,397,600,2,201,397,600,0,0,389,2,6,397,0,1840,2010,True,220,169,sebsi:1  marzouki:1  
3,3,5,33,4,559,318,596,0,278,318,596,0,0,311,4,3,318,0,1815,1902,True,149,162,sebsi:1  marzouki:1  
3,3,5,33,3,561,342,602,0,260,342,602,0,0,340,0,2,342,0,1800,1900,True,150,190,sebsi:1  marzouki:1  
3,3,5,33,2,561,385,600,0,215,385,600,0,0,376,4,5,385,0,1830,1920,True,187,189,sebsi:1  marzouki:1  
3,3,5,33,1,561,404,600,0,196,404,600,0,0,396,6,2,404,0,1810,1900,True,223,173,sebsi:1  marzouki:1  
3,3,4,32,1,572,378,700,0,322,378,700,0,0,366,10,2,378,0,1800,1910,True,222,144,sebsi:1  marzouki:1  
3,3,4,31,4,592,325,692,0,367,325,692,0,0,318,5,2,325,0,1830,1935,True,119,199,sebsi:1  marzouki:1  
3,3,4,31,3,595,382,701,0,319,382,701,0,0,376,3,3,382,0,1815,1910,True,146,230,sebsi:1  marzouki:1  
3,3,4,31,2,595,375,700,3,322,375,700,0,0,372,2,1,372,0,1815,1900,True,161,211,sebsi:1  marzouki:1  
3,3,4,31,1,595,438,700,1,261,438,700,0,0,419,15,4,438,0,1820,1910,True,210,209,sebsi:1  marzouki:1  
3,3,4,30,2,592,316,700,0,384,316,700,0,0,312,4,0,316,0,1815,1925,True,134,178,sebsi:1  marzouki:1  
3,3,4,29,2,540,416,600,0,184,416,600,0,0,408,8,0,416,0,1810,1950,True,199,209,sebsi:1  marzouki:1  
3,3,4,29,1,540,420,600,0,180,420,600,0,0,410,7,3,420,0,1810,1915,True,226,184,sebsi:1  marzouki:1  
3,3,3,28,3,599,364,700,0,336,364,700,0,0,353,8,3,364,0,1820,2000,False,176,177,sebsi:1  marzouki:1  
3,3,3,28,2,600,402,700,0,298,402,700,0,0,402,3,1,406,0,1830,1925,False,203,195,sebsi:1  marzouki:1  
3,3,3,28,1,600,440,700,0,260,440,700,0,0,430,6,4,440,0,1800,1900,False,257,173,sebsi:1  marzouki:1  
3,3,3,27,5,584,302,700,0,398,302,700,0,0,291,5,6,302,0,1800,1900,True,121,170,sebsi:1  marzouki:1  
3,3,3,27,4,584,366,700,0,334,366,700,0,0,359,4,3,366,0,,1903,False,165,194,sebsi:1  marzouki:1  
3,3,3,27,3,584,403,699,0,296,403,699,0,0,389,9,5,403,0,1840,2000,True,183,206,sebsi:1  marzouki:1  
3,3,3,27,2,584,438,700,0,262,438,700,0,0,427,5,6,438,0,1800,1920,True,251,176,sebsi:1  marzouki:1  
3,3,3,27,1,584,437,700,0,263,437,700,0,0,421,10,6,437,0,1810,1900,True,271,150,sebsi:1  marzouki:1  
3,3,3,26,1,130,72,200,0,128,72,200,0,0,71,1,0,72,0,1822,1850,True,41,30,sebsi:1  marzouki:1  
3,3,3,25,3,479,297,600,1,302,297,600,0,0,293,2,2,297,0,1815,1845,True,154,139,sebsi:1  marzouki:1  
3,3,3,25,2,481,352,600,0,248,352,600,0,0,343,3,6,352,0,1815,1905,True,182,161,sebsi:1  marzouki:1  
3,3,3,25,1,481,393,600,1,206,393,600,0,0,391,1,1,393,0,1820,1901,True,247,144,sebsi:1  marzouki:1  
3,3,2,24,6,512,282,600,0,318,282,600,0,0,273,6,3,282,0,1815,1915,False,158,115,sebsi:1  marzouki:1  
3,3,2,24,5,512,289,600,1,310,289,600,0,0,285,1,3,289,0,,1855,True,195,90,sebsi:1  marzouki:1  
3,3,2,24,4,512,345,600,0,255,345,600,0,0,335,6,4,345,0,,1920,True,206,129,sebsi:1  marzouki:1  
3,3,2,24,3,512,343,599,0,256,343,599,0,0,336,2,5,343,0,1815,1855,True,209,127,sebsi:1  marzouki:1  
3,3,2,24,2,512,390,600,0,210,390,600,0,0,385,2,3,390,0,1810,1910,True,280,105,sebsi:1  marzouki:1  
3,3,2,24,1,512,373,600,0,227,373,600,0,0,364,6,3,373,0,1825,1925,False,278,86,sebsi:  marzouki:  
3,3,1,23,8,536,323,601,1,277,323,601,0,0,314,4,5,323,0,1815,1905,True,187,127,sebsi:  marzouki:  
3,3,1,23,7,538,352,599,2,245,352,599,0,0,335,7,10,352,0,1810,1910,True,222,113,sebsi:  marzouki:  
3,3,1,23,6,538,391,600,0,209,391,600,0,0,384,4,3,391,0,1815,1905,True,254,130,sebsi:1  marzouki:1  
3,3,1,23,4,538,394,600,1,205,394,600,0,0,387,4,3,394,0,1830,1935,True,240,147,sebsi:1  marzouki:1  
3,3,1,23,3,538,428,600,0,171,429,600,0,1,417,6,6,429,0,1800,2000,True,272,145,sebsi:1  marzouki:1  
3,3,1,23,2,538,447,597,0,150,447,597,0,0,441,4,2,447,0,1800,2000,False,313,128,sebsi:1  marzouki:1  
3,3,1,23,1,538,423,600,1,178,421,600,0,2,407,6,8,421,0,,1915,True,309,98,sebsi:1  marzouki:1  
3,11,14,143,1,194,116,300,0,184,116,300,0,0,112,3,1,116,0,1800,1830,False,89,23,sebsi:1  marzouki:1  
3,11,14,142,2,338,192,400,0,208,192,400,0,0,187,3,2,192,0,1800,1900,True,128,59,sebsi:1  marzouki:1  
3,11,14,142,1,338,243,402,0,159,243,402,0,0,231,7,5,243,0,1800,1900,True,176,55,sebsi:1  marzouki:1  
3,11,13,141,1,511,307,600,0,293,307,600,0,0,304,2,1,307,0,,1930,True,154,150,sebsi:1  marzouki:1  
3,11,13,140,1,485,296,600,1,303,296,600,0,0,290,4,2,296,0,1830,2000,True,160,130,sebsi:1  marzouki:1  
3,11,13,139,1,295,194,401,6,201,194,401,0,0,187,6,1,194,0,1806,1834,True,127,60,sebsi:1  marzouki:1  
3,11,13,138,2,538,298,602,0,304,298,602,0,0,293,4,1,298,0,1810,1905,True,181,112,sebsi:1  marzouki:1  
3,11,13,138,1,539,332,600,0,268,332,600,0,0,317,14,1,332,0,1815,1900,True,229,88,sebsi:1  marzouki:1  
3,11,12,137,1,258,157,300,1,142,157,300,0,0,155,1,1,157,0,1810,1845,True,71,84,sebsi:1  marzouki:1  
3,11,12,136,3,439,262,500,0,238,262,500,0,0,260,1,1,262,0,1800,1910,True,100,160,sebsi:1  marzouki:1  
3,11,12,136,2,440,299,500,1,200,299,500,0,0,292,3,4,299,0,1815,1905,True,121,171,sebsi:1  marzouki:1  
3,11,12,136,1,440,301,500,0,199,301,500,0,0,285,7,9,301,0,1820,1907,True,162,123,sebsi:1  marzouki:1  
3,11,11,135,1,348,183,396,0,213,183,396,0,0,174,3,6,183,0,1810,1840,True,84,90,sebsi:1  marzouki:1  
3,11,11,134,3,501,252,600,0,348,252,600,0,0,247,4,1,252,0,1830,1900,True,131,116,sebsi:1  marzouki:1  
3,11,11,134,2,502,318,598,0,280,318,598,0,0,309,9,0,318,0,1815,1913,True,164,145,sebsi:1  marzouki:1  
3,11,11,134,1,502,326,591,2,265,324,591,0,2,314,6,4,324,0,1810,1905,True,210,104,sebsi:1  marzouki:1  
3,11,10,133,3,410,212,500,0,288,212,500,0,0,208,3,1,212,0,1810,1850,True,118,90,sebsi:1  marzouki:1  
3,11,10,133,2,410,267,500,0,233,267,500,0,0,261,5,1,267,0,1810,1915,False,156,105,sebsi:1  marzouki:1  
3,11,10,133,1,410,290,500,0,210,290,500,0,0,282,7,1,290,0,1810,1900,True,225,57,sebsi:1  marzouki:1  
3,11,10,132,2,317,179,400,0,221,179,400,0,0,179,0,0,179,0,1800,1835,True,108,71,sebsi:1  marzouki:1  
3,11,10,132,1,317,221,400,0,179,221,400,0,0,217,3,1,221,0,1800,1835,True,152,65,sebsi:1  marzouki:1  
3,11,9,131,1,365,168,400,0,232,168,400,0,0,162,3,3,168,0,1800,1900,True,93,69,sebsi:1  marzouki:1  
3,11,8,130,1,114,61,200,0,139,61,200,0,0,57,4,0,61,0,1815,1830,True,54,3,sebsi:1  marzouki:1  
3,11,8,129,1,208,115,301,0,186,115,301,0,0,115,0,0,115,0,1800,1900,True,60,55,sebsi:1  marzouki:1  
3,11,7,128,1,272,156,300,0,144,156,300,0,0,151,3,2,156,0,1800,1845,True,106,45,sebsi:1  marzouki:1  
3,11,7,127,2,300,149,400,0,251,149,400,0,0,146,2,1,149,0,1815,1845,True,108,38,sebsi:1  marzouki:1  
3,11,5,122,2,330,187,400,0,213,187,400,0,0,182,1,4,187,0,1815,1845,True,96,86,sebsi:1  marzouki:1  
3,11,5,122,1,331,198,400,0,202,198,400,0,0,193,3,2,198,0,1815,1835,False,131,62,sebsi:1  marzouki:1  
3,11,4,121,2,350,196,392,1,195,196,392,0,0,194,1,1,196,0,1800,1853,True,94,100,sebsi:1  marzouki:1  
3,11,4,121,1,350,262,400,0,138,262,400,0,0,252,5,5,262,0,1900,1900,True,178,74,sebsi:1  marzouki:1  
3,11,4,120,4,454,262,500,0,238,262,500,0,0,254,5,3,262,0,1830,1911,True,133,121,sebsi:1  marzouki:1  
3,11,4,120,3,456,298,499,0,201,298,499,0,0,293,3,2,298,0,1810,1915,True,150,143,sebsi:1  marzouki:1  
3,11,4,120,2,456,307,505,0,198,307,505,0,0,304,2,1,307,0,1830,1930,True,182,122,sebsi:1  marzouki:1  
3,11,4,120,1,456,335,501,0,167,334,501,0,1,317,16,1,334,0,1830,1950,False,216,101,sebsi:1  marzouki:1  
3,11,3,119,2,555,283,600,0,317,283,600,0,0,280,3,0,283,0,1820,1910,True,125,155,sebsi:1  marzouki:1  
3,11,3,119,1,556,375,600,0,225,375,600,0,0,365,8,2,375,0,,1935,True,193,172,sebsi:1  marzouki:1  
3,11,3,118,2,571,290,700,0,410,290,700,0,0,285,3,2,290,0,1810,2030,True,162,123,sebsi:1  marzouki:1  
3,11,3,118,1,572,402,700,1,297,402,700,0,0,398,3,1,402,0,1815,1900,True,274,124,sebsi:1  marzouki:1  
3,11,2,117,5,505,312,600,0,288,312,600,0,0,301,5,6,312,0,1840,1945,True,129,172,sebsi:1  marzouki:1  
3,11,2,117,4,505,300,600,1,299,300,600,0,0,299,0,1,300,0,1830,1915,True,153,146,sebsi:1  marzouki:1  
3,11,2,117,3,505,346,600,0,254,346,600,0,0,345,0,1,346,0,1840,1945,True,182,163,sebsi:1  marzouki:1  
3,11,2,117,2,505,366,600,0,234,366,600,0,0,356,8,2,366,0,1850,1940,True,199,157,sebsi:1  marzouki:1  
3,11,2,117,1,505,395,599,0,204,395,599,0,0,386,2,7,395,0,1830,1935,True,258,128,sebsi:1  marzouki:1  
3,11,2,116,2,581,364,700,0,336,364,700,0,0,354,7,3,364,0,1815,1905,True,166,188,sebsi:1  marzouki:1  
3,11,2,116,1,582,423,700,0,277,423,700,0,0,411,5,7,423,0,1810,1900,True,212,199,sebsi:1  marzouki:1  
3,11,1,115,3,501,303,600,0,297,303,600,0,0,297,3,3,303,0,1814,1846,True,120,177,sebsi:1  marzouki:1  
3,11,1,115,2,502,335,600,0,265,335,600,0,0,329,3,3,335,0,1815,1915,True,158,171,sebsi:1  marzouki:1  
3,11,1,115,1,502,363,608,0,246,362,608,0,1,342,11,9,362,0,1815,,True,182,160,sebsi:1  marzouki:1  
3,11,1,114,2,356,214,400,0,186,214,400,0,0,211,2,1,214,0,1800,1905,True,123,88,sebsi:1  marzouki:1  
3,11,1,114,1,356,260,409,0,149,260,409,0,0,256,1,3,260,0,1810,1856,True,168,88,sebsi:1  marzouki:1  
3,11,1,113,7,541,348,600,1,251,348,600,0,0,332,9,7,348,0,1827,1925,True,163,169,sebsi:1  marzouki:1  
3,11,1,113,6,546,326,600,0,274,326,600,0,0,311,11,4,326,0,1835,1935,True,157,154,sebsi:1  marzouki:1  
3,11,1,113,5,546,334,600,0,266,334,600,0,0,324,4,6,334,0,1815,1900,True,160,164,sebsi:1  marzouki:1  
3,11,1,113,4,546,404,600,0,196,404,600,0,0,392,4,8,404,0,1840,1940,True,196,196,sebsi:1  marzouki:1  
3,11,1,113,3,546,420,600,0,180,420,600,0,0,413,7,0,420,0,1820,1915,True,226,187,sebsi:1  marzouki:1  
3,11,1,113,2,546,394,604,0,210,394,604,0,0,378,10,6,394,0,1830,2030,True,239,139,sebsi:1  marzouki:1  
3,11,1,113,1,546,424,597,1,173,423,597,0,1,416,5,2,423,0,1835,2005,True,290,126,sebsi:1  marzouki:1  
3,2,5,22,1,445,235,500,0,265,235,500,0,0,234,0,1,235,0,,1848,True,165,69,sebsi:1  marzouki:1  
3,2,4,21,2,451,270,501,0,231,270,501,0,0,266,2,2,270,0,1810,1903,True,119,147,sebsi:1  marzouki:1  
3,2,4,21,1,451,316,500,1,183,316,500,0,0,313,2,1,316,0,1800,1851,True,165,148,sebsi:1  marzouki:1  
3,2,4,20,6,563,348,600,0,252,348,600,0,0,341,4,3,348,0,1815,1911,False,154,187,sebsi:1  marzouki:1  
3,2,4,20,5,568,296,600,0,304,296,600,0,0,291,2,3,296,0,1815,1915,True,138,153,sebsi:1  marzouki:1  
3,2,4,20,4,568,381,600,0,219,381,600,0,0,375,4,2,381,0,1800,1909,True,158,217,sebsi:1  marzouki:1  
3,2,3,18,2,545,309,607,0,298,309,607,0,0,303,1,5,309,0,1802,1905,True,109,194,sebsi:1  marzouki:1  
3,2,3,18,1,545,361,600,0,239,361,600,0,0,351,4,6,361,0,1815,1910,True,167,184,sebsi:1  marzouki:1  
3,2,3,17,3,436,202,500,1,297,202,500,0,0,199,1,2,202,0,1819,1902,True,80,119,sebsi:1  marzouki:1  
3,2,3,17,2,436,245,500,0,255,245,500,0,0,241,3,1,245,0,1820,1903,True,108,133,sebsi:1  marzouki:1  
3,2,3,17,1,436,296,501,0,205,296,501,0,0,281,9,6,296,0,1815,1900,True,149,132,sebsi:1  marzouki:1  
3,2,3,16,5,582,305,700,0,395,305,700,0,0,300,4,1,305,0,1800,1900,False,110,190,sebsi:1  marzouki:1  
3,2,3,16,4,586,330,700,0,370,330,700,0,0,324,3,3,330,0,1800,1915,True,140,184,sebsi:1  marzouki:1  
3,2,3,16,3,586,383,700,1,316,383,700,0,0,375,7,1,383,0,1800,1915,True,130,245,sebsi:1  marzouki:1  
3,2,3,16,2,586,417,700,0,283,417,700,0,0,402,5,10,417,0,1800,,False,167,235,sebsi:1  marzouki:1  
3,2,3,16,1,586,445,701,2,254,445,701,0,0,428,13,4,445,0,1800,1900,False,236,192,sebsi:1  marzouki:1  
3,2,2,15,2,424,210,500,0,290,210,500,0,0,207,1,2,210,0,1810,1845,True,106,101,sebsi:1  marzouki:1  
3,2,2,15,1,424,258,501,0,243,258,501,0,0,251,5,2,258,0,1800,1905,True,121,130,sebsi:1  marzouki:1  
3,2,2,14,1,507,257,600,0,343,257,600,0,0,250,6,1,257,0,1818,1910,True,123,127,sebsi:1  marzouki:1  
3,2,2,13,2,600,277,600,1,322,277,600,0,0,275,1,1,277,0,1800,1845,True,123,152,sebsi:1  marzouki:1  
3,2,2,13,1,515,344,600,0,256,344,600,0,0,330,2,12,344,0,1815,1915,True,177,153,sebsi:1  marzouki:1  
3,2,2,12,6,545,284,600,0,316,284,600,0,0,281,2,1,284,0,1800,1845,True,86,195,sebsi:1  marzouki:1  
3,2,2,12,5,549,251,600,0,349,251,600,0,0,245,6,0,251,0,1800,1855,True,77,168,sebsi:1  marzouki:1  
3,2,2,12,4,549,330,600,0,270,330,600,0,0,322,3,5,330,0,1815,1900,False,108,214,sebsi:1  marzouki:1  
3,2,2,12,3,549,344,600,0,256,344,600,0,0,343,1,0,344,0,1800,1901,False,130,213,sebsi:1  marzouki:1  
3,2,2,12,2,549,387,600,0,213,387,600,0,0,364,19,4,387,0,1800,1920,True,155,209,sebsi:1  marzouki:1  
3,2,2,12,1,549,370,600,1,229,370,600,0,0,356,8,6,370,0,1805,1940,True,171,185,sebsi:1  marzouki:1  
3,2,1,11,1,395,244,500,1,255,244,500,0,0,237,3,4,244,0,1800,1845,False,93,144,sebsi:1  marzouki:1  
3,2,1,10,3,545,309,600,1,290,309,600,0,0,298,7,4,309,0,1800,1900,True,124,174,sebsi:1  marzouki:1  
3,2,1,10,2,545,369,600,0,231,369,600,0,0,360,5,4,369,0,,1920,False,142,218,sebsi:1  marzouki:1  
3,2,1,10,1,545,400,600,0,200,400,600,0,0,389,7,4,400,0,1815,1921,True,168,221,sebsi:1  marzouki:1  
3,2,1,9,3,549,264,600,0,336,264,600,0,0,257,5,2,264,0,1820,1850,False,87,170,sebsi:1  marzouki:1  
3,2,1,9,2,550,343,600,1,256,343,600,0,0,340,1,2,343,0,1800,,True,125,215,sebsi:1  marzouki:2  
3,2,1,9,1,550,383,600,1,216,383,600,0,0,372,3,8,383,0,,1920,False,187,185,sebsi:1  marzouki:1  
3,2,1,8,3,538,299,613,1,313,299,613,0,0,293,2,4,299,0,1805,1845,False,90,203,sebsi:1  marzouki:1  
3,12,7,151,1,454,315,500,0,185,315,500,0,0,307,4,4,315,0,1815,1855,True,209,98,sebsi:1  marzouki:1  
3,12,6,150,3,573,409,700,0,291,409,700,0,0,397,8,4,409,0,1830,1925,True,293,104,sebsi:1  marzouki:1  
3,12,6,150,2,573,453,700,1,246,453,700,0,0,441,5,7,453,0,1841,1959,True,309,132,sebsi:1  marzouki:1  
3,12,6,150,1,573,482,700,0,219,481,700,0,1,466,14,1,481,0,1830,2000,True,365,101,sebsi:  marzouki:  
3,12,6,149,2,425,311,501,0,190,311,501,0,0,302,9,0,311,0,1815,1912,True,199,103,sebsi:1  marzouki:1  
3,12,6,149,1,426,330,501,0,171,330,501,0,0,325,4,1,330,0,,2000,True,231,94,sebsi:1  marzouki:1  
3,12,5,148,5,597,312,700,0,388,312,700,0,0,301,7,4,312,0,1830,1950,True,182,119,sebsi:1  marzouki:1  
3,12,5,148,4,598,355,704,0,349,355,704,0,0,348,4,3,355,0,1820,1915,True,198,150,sebsi:1  marzouki:1  
3,12,5,148,3,598,386,700,0,315,385,700,0,1,375,3,7,385,0,,1930,True,220,155,sebsi:1  marzouki:1  
3,12,5,148,2,598,441,700,0,259,441,700,0,0,429,7,5,441,0,1820,1920,True,300,129,sebsi:1  marzouki:1  
3,12,5,148,1,598,415,700,0,285,415,700,0,0,396,11,8,415,0,1830,1932,True,309,87,sebsi:1  marzouki:1  
3,12,4,147,4,503,277,588,0,311,277,588,0,0,270,5,2,277,0,1800,1915,True,151,119,sebsi:1  marzouki:1  
3,12,4,147,3,503,323,600,0,277,323,600,0,0,312,8,3,323,0,1815,1915,False,195,117,sebsi:1  marzouki:1  
3,12,4,147,2,503,381,600,1,218,381,600,0,0,371,10,0,381,0,1830,1945,True,231,140,sebsi:1  marzouki:1  
3,12,4,147,1,503,370,600,0,230,370,600,0,0,347,17,6,370,0,1815,1900,True,273,74,sebsi:1  marzouki:1  
3,12,3,146,5,532,348,600,0,252,348,600,0,0,332,11,5,348,0,1833,1930,True,184,148,sebsi:1  marzouki:1  
3,12,3,146,4,534,369,600,0,231,369,600,0,0,359,5,5,369,0,1825,1930,True,198,161,sebsi:1  marzouki:1  
3,12,3,146,3,534,383,600,0,217,383,600,0,0,379,3,1,383,0,1826,1944,True,199,180,sebsi:1  marzouki:1  
3,12,3,146,2,534,421,596,0,175,421,596,0,0,414,5,2,421,0,1815,2000,True,267,147,sebsi:1  marzouki:1  
3,12,3,146,1,534,447,588,0,141,447,588,0,0,432,9,6,447,0,1830,1930,True,297,135,sebsi:1  marzouki:1  
3,12,2,145,4,456,301,500,1,198,301,500,0,0,286,7,8,301,0,1820,2013,True,187,99,sebsi:1  marzouki:1  
3,12,2,145,3,456,323,502,0,179,323,502,0,0,314,1,8,323,0,1827,1927,True,190,124,sebsi:1  marzouki:1  
3,12,2,145,2,456,339,500,3,160,337,500,0,2,327,6,4,337,0,1837,2005,True,211,116,sebsi:1  marzouki:1  
3,12,2,145,1,456,357,492,0,135,357,492,0,0,353,4,0,357,0,,1950,True,276,77,sebsi:1  marzouki:1  
3,12,1,144,7,588,427,700,0,273,427,700,0,0,400,16,11,427,0,1900,1940,True,272,128,sebsi:1  marzouki:1  
3,12,1,144,6,593,445,700,0,255,445,700,0,0,438,3,4,445,0,1900,2001,True,277,161,sebsi:1  marzouki:1  
3,12,1,144,5,593,461,700,0,239,461,700,0,0,451,5,5,461,0,1825,1955,True,323,128,sebsi:1  marzouki:1  
3,12,1,144,4,593,480,700,2,218,480,700,0,0,469,10,1,480,0,1835,2050,True,315,154,sebsi:1  marzouki:1  
3,12,1,144,3,593,491,708,0,217,491,708,0,0,478,5,8,491,0,,2051,True,337,141,sebsi:1  marzouki:1  
3,12,1,144,2,593,490,700,1,209,490,700,0,0,481,2,7,490,0,1830,2000,True,358,123,sebsi:1  marzouki:1  
3,7,4,75,5,543,371,600,0,229,371,600,0,0,362,7,2,371,0,1815,1935,True,196,166,sebsi:1  marzouki:1  
3,7,4,75,4,543,409,601,0,192,409,601,0,0,400,4,5,409,0,1820,1915,False,205,195,sebsi:1  marzouki:1  
3,7,4,75,3,543,388,600,0,212,388,600,0,0,374,5,9,388,0,1820,1930,True,202,172,sebsi:1  marzouki:1  
3,7,4,75,2,543,412,600,3,185,412,600,0,0,402,9,1,412,0,1800,2000,True,241,161,sebsi:1  marzouki:1  
3,7,4,75,1,543,432,600,5,163,432,600,0,0,420,8,4,432,0,1800,2000,True,280,140,sebsi:1  marzouki:1  
3,7,3,74,3,523,314,607,0,293,314,607,0,0,310,2,2,314,0,1815,1900,True,167,143,sebsi:1  marzouki:1  
3,7,3,74,2,524,370,600,1,229,370,600,0,0,355,12,3,370,0,1815,1946,True,164,191,sebsi:1  marzouki:1  
3,7,3,74,1,524,410,604,1,193,410,604,0,0,398,11,1,410,0,1815,1950,True,252,146,sebsi:1  marzouki:1  
3,7,3,73,6,571,389,699,0,310,389,699,0,0,375,7,7,389,0,1835,1940,True,183,192,sebsi:1  marzouki:1  
3,7,3,73,5,572,393,696,0,303,393,696,0,0,381,7,5,393,0,1815,1930,False,186,195,sebsi:1  marzouki:1  
3,7,3,73,4,572,452,692,1,239,452,692,0,0,442,5,5,452,0,1815,1915,False,212,230,sebsi:1  marzouki:1  
3,7,3,73,3,572,411,700,0,289,411,700,0,0,404,5,2,411,0,1835,1945,False,230,174,sebsi:1  marzouki:1  
3,7,3,73,2,572,464,708,1,243,464,708,0,0,455,5,4,464,0,1825,2011,True,268,187,sebsi:1  marzouki:1  
3,7,3,73,1,572,447,701,1,253,447,701,0,0,437,3,7,447,0,1800,1945,True,286,151,sebsi:1  marzouki:1  
3,7,2,72,2,571,408,696,0,288,408,696,0,0,398,7,3,408,0,1820,1940,True,235,163,sebsi:1  marzouki:1  
3,7,2,72,1,572,455,698,2,241,455,698,0,0,447,4,4,455,0,1830,1920,True,311,136,sebsi:1  marzouki:1  
3,7,2,71,6,572,363,700,0,337,363,700,0,0,348,11,4,363,0,1820,1950,True,244,104,sebsi:1  marzouki:1  
3,7,2,71,5,577,408,700,0,292,408,700,0,0,401,4,3,408,0,1830,2005,True,281,120,sebsi:1  marzouki:1  
3,7,2,71,4,577,442,700,2,256,442,700,0,0,433,5,4,442,0,1820,1945,True,289,144,sebsi:1  marzouki:1  
3,7,2,71,3,577,449,700,0,251,449,700,0,0,438,7,4,449,0,1800,1900,True,310,128,sebsi:1  marzouki:1  
3,7,2,71,2,577,479,700,0,221,479,700,0,0,466,6,7,479,0,1815,1931,True,352,114,sebsi:1  marzouki:1  
3,7,2,71,1,577,459,701,0,242,459,701,0,0,441,7,11,459,0,1800,1900,True,354,87,sebsi:1  marzouki:1  
3,7,1,70,8,533,352,600,0,248,352,600,0,0,338,9,5,352,0,1830,2005,False,221,117,sebsi:1  marzouki:1  
3,7,1,70,7,538,340,600,0,260,340,600,0,0,330,7,3,340,0,1825,1925,False,199,131,sebsi:1  marzouki:1  
3,7,1,70,6,538,392,600,0,208,392,600,0,0,387,1,4,392,0,1815,1925,False,258,129,sebsi:1  marzouki:1  
3,7,1,70,5,538,426,594,0,168,426,594,0,0,413,7,6,426,0,1820,1930,True,276,137,sebsi:1  marzouki:1  
3,7,1,70,4,538,418,600,0,182,418,600,0,0,408,6,4,418,0,,1910,True,282,126,sebsi:1  marzouki:1  
3,7,1,70,3,538,461,600,0,139,461,600,0,0,456,3,2,461,0,1800,1930,False,310,146,sebsi:1  marzouki:1  
3,7,1,70,2,538,441,600,1,158,441,600,0,0,436,2,3,441,0,1900,1930,False,299,137,sebsi:1  marzouki:1  
3,7,1,70,1,538,432,600,1,167,432,600,0,0,417,10,5,432,0,1835,2005,True,337,80,sebsi:1  marzouki:1  
3,7,1,69,5,587,426,692,1,265,426,692,0,0,414,8,4,426,0,1820,2000,True,286,128,sebsi:1  marzouki:1  
3,7,1,69,4,587,469,700,0,231,469,700,0,0,458,2,9,469,0,1800,1930,True,325,133,sebsi:1  marzouki:1  
3,7,1,69,3,587,464,700,4,232,464,700,0,0,453,7,4,464,0,1820,1915,False,338,115,sebsi:1  marzouki:1  
3,7,1,69,2,587,455,700,0,245,455,700,0,0,442,12,1,455,0,1815,1945,True,353,89,sebsi:1  marzouki:1  
3,8,3,83,7,600,380,600,1,219,380,600,0,0,354,15,11,380,0,1820,1913,True,204,150,sebsi:1  marzouki:1  
3,8,3,83,6,600,359,700,0,341,359,700,0,0,350,6,3,359,0,1800,1920,True,199,151,sebsi:1  marzouki:1  
3,8,3,83,5,600,417,600,1,182,417,600,0,0,408,2,7,417,0,1800,1900,True,240,168,sebsi:1  marzouki:1  
3,8,3,83,4,600,429,708,0,279,429,708,0,0,419,5,5,429,0,1807,1935,True,217,202,sebsi:1  marzouki:1  
3,8,3,83,3,600,483,700,0,217,483,700,0,0,470,8,5,483,0,,1945,True,267,203,sebsi:1  marzouki:1  
3,8,3,83,2,600,478,705,1,226,478,705,0,0,472,3,3,478,0,1815,1930,True,326,146,sebsi:1  marzouki:1  
3,8,3,83,1,600,478,701,1,222,478,701,0,0,469,4,5,478,0,1815,1955,False,334,135,sebsi:1  marzouki:1  
3,8,3,82,5,579,382,600,0,218,382,600,0,0,363,14,5,382,0,1800,,True,219,144,sebsi:1  marzouki:1  
3,8,3,82,4,582,368,700,0,332,368,700,0,0,360,6,2,368,0,1830,1930,True,235,125,sebsi:1  marzouki:1  
3,8,3,82,3,582,411,704,0,293,411,704,0,0,403,5,3,411,0,1830,2000,True,223,180,sebsi:1  marzouki:1  
3,8,3,82,2,582,469,700,2,229,469,700,0,0,458,5,6,469,0,1840,,False,279,179,sebsi:1  marzouki:1  
3,8,3,82,1,582,475,700,1,224,475,700,0,0,470,3,2,475,0,1830,1915,True,349,121,sebsi:1  marzouki:1  
3,8,2,81,6,572,413,700,0,287,413,700,0,0,392,14,7,413,0,1820,1930,True,199,193,sebsi:1  marzouki:1  
3,8,2,81,5,575,388,600,0,212,388,600,0,0,378,5,5,388,0,1820,1940,True,169,209,sebsi:1  marzouki:1  
3,8,2,81,4,575,432,600,0,168,432,600,0,0,425,2,5,432,0,1830,1905,False,216,209,sebsi:1  marzouki:1  
3,8,2,81,3,575,460,600,3,137,460,600,0,0,454,5,1,460,0,1825,1935,True,205,249,sebsi:1  marzouki:1  
3,8,2,81,2,575,476,700,0,224,476,700,0,0,467,6,3,476,0,1815,1930,False,243,224,sebsi:1  marzouki:1  
3,8,2,81,1,575,496,601,0,105,496,601,0,0,486,4,6,496,0,1830,1915,True,304,182,sebsi:1  marzouki:1  
3,8,2,80,1,574,363,699,1,335,363,699,0,0,355,6,2,363,0,1820,1925,True,205,150,sebsi:1  marzouki:1  
3,8,2,79,5,542,224,600,1,375,224,600,0,0,219,4,1,224,0,1810,1852,True,101,118,sebsi:1  marzouki:1  
3,8,2,79,4,544,257,601,0,344,257,601,0,0,249,5,3,257,0,1805,1900,True,136,113,sebsi:1  marzouki:1  
3,8,2,79,3,544,327,600,0,273,327,600,0,0,321,4,2,327,0,1823,1906,False,186,135,sebsi:1  marzouki:2  
3,8,2,79,2,544,339,600,1,260,339,600,0,0,329,3,7,339,0,1820,1915,False,198,131,sebsi:1  marzouki:1  
3,8,2,79,1,544,391,600,1,208,391,600,0,0,371,15,5,391,0,1815,1900,True,279,92,sebsi:1  marzouki:1  
3,8,1,78,6,513,266,600,0,334,266,600,0,0,258,3,5,266,0,,1920,True,117,141,sebsi:1  marzouki:1  
3,8,1,78,5,518,312,600,0,288,312,600,0,0,302,7,3,312,0,1800,1920,False,146,156,sebsi:1  marzouki:1  
3,8,1,78,4,518,367,600,1,233,366,600,0,1,359,6,1,366,0,1820,1900,True,180,179,sebsi:1  marzouki:1  
3,8,1,78,3,518,375,597,0,222,375,597,0,0,365,6,4,375,0,1820,2000,True,178,187,sebsi:1  marzouki:1  
3,8,1,78,2,518,408,602,0,194,408,602,0,0,400,7,1,8,400,1830,1935,True,243,157,sebsi:1  marzouki:1  
3,10,7,112,2,526,238,599,0,361,238,599,0,0,234,2,2,238,0,1805,1910,True,147,87,sebsi:1  marzouki:1  
3,10,7,112,1,527,328,600,0,272,328,600,0,0,319,7,2,328,0,1830,1900,True,231,88,sebsi:1  marzouki:1  
3,10,6,111,1,454,265,500,0,236,265,501,1,0,258,5,2,265,0,1800,1900,True,152,106,sebsi:1  marzouki:1  
3,10,6,110,4,491,257,600,1,342,257,600,0,0,252,2,3,257,0,1820,1900,True,101,151,sebsi:1  marzouki:1  
3,10,6,110,3,493,270,600,1,329,270,600,0,0,267,3,0,270,0,1800,1900,True,107,160,sebsi:1  marzouki:1  
3,10,6,110,2,493,322,600,0,278,322,600,0,0,319,1,2,322,0,1800,1910,True,183,136,sebsi:1  marzouki:1  
3,10,6,110,1,493,336,600,1,263,336,600,0,0,326,5,5,336,0,1805,1904,True,186,140,sebsi:1  marzouki:1  
3,10,5,109,5,521,206,605,0,399,206,605,0,0,205,1,0,206,206,1825,1900,True,85,120,sebsi:2  marzouki:2  
3,10,5,109,4,525,233,600,2,365,233,600,0,0,228,4,1,233,0,1815,1940,True,99,129,sebsi:2  marzouki:2  
3,10,5,109,3,525,274,600,1,325,274,600,0,0,268,3,3,274,0,1815,1900,True,124,144,sebsi:1  marzouki:1  
3,10,5,109,2,525,314,600,1,285,314,600,0,0,308,3,3,314,0,1830,1930,True,178,130,sebsi:1  marzouki:1  
3,10,5,109,1,525,324,600,0,276,324,600,600,0,317,6,1,324,0,1800,1920,True,182,135,sebsi:1  marzouki:1  
3,10,5,108,8,559,227,600,0,373,227,600,0,0,224,2,1,227,0,1815,1900,False,107,117,sebsi:1  marzouki:1  
3,10,5,108,7,562,254,600,0,346,254,600,0,0,247,5,2,254,0,1815,1905,True,108,139,sebsi:1  marzouki:1  
3,10,5,108,6,562,272,600,0,328,272,600,0,0,265,5,2,272,0,1800,1850,False,131,134,sebsi:1  marzouki:1  
3,10,5,108,5,562,299,600,0,301,299,600,0,0,297,2,0,299,0,1805,1900,False,152,145,sebsi:1  marzouki:1  
3,10,5,108,4,562,342,600,0,258,342,600,0,0,335,6,1,342,0,1825,1931,False,175,160,sebsi:1  marzouki:1  
3,10,5,108,3,562,343,600,0,257,343,600,0,0,337,4,2,343,0,1812,1925,False,198,139,sebsi:1  marzouki:1  
3,10,5,108,2,562,375,600,0,225,375,600,0,0,369,6,0,375,0,1815,1900,False,236,133,sebsi:1  marzouki:1  
3,10,5,108,1,562,393,599,0,207,392,599,0,1,385,4,3,392,0,1810,1955,False,275,110,sebsi:1  marzouki:1  
3,10,4,107,2,487,305,600,0,295,305,600,0,0,300,3,2,305,0,1815,1915,True,129,171,sebsi:1  marzouki:1  
3,10,4,107,1,488,360,599,0,239,360,599,0,0,354,6,0,360,0,1830,1930,True,176,178,sebsi:1  marzouki:1  
3,10,4,106,2,425,252,500,0,248,252,500,0,0,249,1,2,252,0,1820,1915,False,133,116,sebsi:1  marzouki:1  
3,10,4,106,1,426,292,500,0,208,292,500,0,0,285,7,0,292,0,1815,1900,False,199,86,sebsi:1  marzouki:1  
3,10,3,105,2,440,256,500,0,244,256,500,0,0,248,4,4,256,0,1815,1907,False,102,146,sebsi:1  marzouki:1  
3,10,3,105,1,441,314,502,0,188,314,502,0,0,308,5,1,314,0,1830,1923,False,149,159,sebsi:1  marzouki:1  
3,10,3,104,4,519,277,600,1,322,277,600,0,0,273,2,2,277,0,1825,1900,True,113,160,sebsi:1  marzouki:1  
3,10,3,104,3,522,288,600,0,313,287,600,0,1,281,3,3,287,0,1815,1900,False,109,172,sebsi:1  marzouki:1  
3,10,3,104,2,522,379,596,0,218,378,596,0,1,372,3,3,378,0,,1900,False,157,215,sebsi:1  marzouki:1  
3,10,3,104,1,522,394,600,0,206,394,600,0,0,383,3,8,394,0,1820,1910,True,213,170,sebsi:1  marzouki:1  
3,10,3,103,3,534,377,600,0,223,377,600,0,0,363,8,6,377,0,1830,1930,True,145,218,sebsi:1  marzouki:1  
3,10,3,103,2,535,400,601,0,201,400,601,0,0,396,1,3,400,0,,1910,True,154,242,sebsi:1  marzouki:1  
3,10,3,103,1,535,426,600,0,174,426,600,0,0,419,3,4,426,0,1830,1930,True,157,262,sebsi:1  marzouki:1  
3,10,3,102,4,454,254,501,1,246,254,501,0,0,250,3,1,254,0,1810,1842,False,112,138,sebsi:1  marzouki:1  
3,10,3,102,3,454,283,501,0,218,283,501,0,0,281,2,0,283,0,1810,1855,False,124,157,sebsi:1  marzouki:1  
3,10,3,102,2,454,293,500,0,207,293,500,0,0,286,6,1,293,0,1810,1910,True,163,123,sebsi:1  marzouki:1  
3,10,3,102,1,454,333,500,1,167,332,500,0,1,323,8,1,332,0,1815,1930,True,212,111,sebsi:1  marzouki:1  
3,10,2,101,3,471,273,500,0,227,273,500,0,0,265,3,5,273,0,1805,1910,True,106,159,sebsi:1  marzouki:1  
3,10,2,101,2,472,304,500,0,196,304,500,0,0,301,1,2,304,0,1815,1842,True,120,181,sebsi:2  marzouki:1  
3,10,2,101,1,472,345,500,1,154,345,500,0,0,331,10,4,345,0,1810,1905,True,152,179,sebsi:2  marzouki:1  
3,10,2,100,1,237,128,300,0,172,128,300,0,0,124,4,0,128,0,1810,1845,True,50,74,sebsi:2  marzouki:1  
3,10,2,99,5,581,332,700,0,368,332,700,0,0,324,4,4,332,0,1820,1910,True,133,191,sebsi:1  marzouki:0  
3,10,2,99,4,583,359,700,1,340,359,700,0,0,348,8,3,359,0,1800,1900,True,140,208,sebsi:1  marzouki:1  
3,10,2,99,3,583,377,685,0,308,377,685,0,0,366,8,3,377,0,1815,1915,True,167,199,sebsi:1  marzouki:1  
3,10,2,99,2,583,417,701,0,284,417,701,0,0,406,5,6,417,0,1800,2000,True,200,206,sebsi:1  marzouki:1  
3,10,2,99,1,583,434,700,0,266,434,700,0,0,417,8,9,434,0,1800,1857,True,232,185,sebsi:1  marzouki:1  
3,10,1,98,4,592,325,700,0,375,325,700,0,0,315,9,1,325,0,1830,1942,True,109,206,sebsi:1  marzouki:1  
3,10,1,98,3,593,352,699,0,347,352,699,0,0,348,3,1,352,0,1830,1930,True,133,215,sebsi:1  marzouki:1  
3,10,1,98,2,593,397,700,0,303,397,700,0,0,388,3,6,397,0,1830,1930,False,183,205,sebsi:1  marzouki:1  
3,10,1,98,1,700,436,700,0,264,436,700,0,0,428,4,4,436,0,1810,1945,False,251,177,sebsi:1  marzouki:1  
3,10,1,97,7,531,277,600,0,323,277,600,0,0,269,3,5,277,0,1835,1936,True,109,160,sebsi:1  marzouki:1  
3,10,1,97,6,535,288,600,0,312,288,600,0,0,281,3,4,288,0,1830,1900,False,122,159,sebsi:1  marzouki:1  
3,10,1,97,5,535,357,600,0,243,357,600,0,0,353,2,2,357,0,1830,1926,True,150,203,sebsi:1  marzouki:1  
3,10,1,97,4,535,347,600,0,253,347,600,0,0,338,7,2,347,0,1815,1920,True,143,195,sebsi:1  marzouki:1  
3,10,1,97,3,535,342,600,0,258,342,600,0,0,335,6,1,342,0,1830,1948,False,176,159,sebsi:1  marzouki:1  
3,10,1,97,2,535,372,600,0,228,372,600,0,0,364,5,3,372,0,1830,1920,True,216,148,sebsi:1  marzouki:1  
3,10,1,97,1,535,375,600,0,225,375,600,0,0,367,3,5,375,0,1810,1915,False,247,120,sebsi:1  marzouki:1  
3,1,4,6,2,521,340,600,0,260,340,600,0,0,327,8,5,340,0,1815,1908,True,195,132,sebsi:1  marzouki:1  
3,1,4,6,1,521,369,600,1,230,369,600,0,0,357,5,7,369,0,1825,1930,True,251,106,sebsi:1  marzouki:1  
3,1,3,5,2,582,366,700,0,334,366,700,0,0,359,3,4,366,0,1815,1910,True,244,115,sebsi:1  marzouki:1  
3,1,3,4,8,525,350,600,0,250,350,600,0,0,337,7,6,350,0,1830,1925,False,215,122,sebsi:1  marzouki:1  
3,1,3,4,7,527,382,600,0,218,382,600,0,0,371,3,8,382,0,1900,2000,True,238,133,sebsi:1  marzouki:1  
3,1,3,4,6,527,358,600,1,243,356,600,0,0,342,3,11,356,0,1845,1955,True,203,139,sebsi:1  marzouki:1  
3,1,3,4,5,527,444,600,1,155,444,600,0,0,428,15,1,444,0,1935,2020,True,264,164,sebsi:1  marzouki:1  
3,1,3,4,4,527,409,600,2,189,409,600,0,0,400,3,6,409,0,1900,2005,True,254,146,sebsi:1  marzouki:1  
3,1,3,4,3,527,442,600,0,158,442,600,0,0,433,6,3,442,0,1900,2005,True,293,140,sebsi:1  marzouki:1  
3,1,3,4,2,527,426,600,0,174,426,600,0,0,411,11,4,426,0,1851,2011,True,297,114,sebsi:1  marzouki:1  
3,1,3,4,1,527,428,600,5,166,429,600,0,1,416,7,6,429,0,1815,,True,305,111,sebsi:1  marzouki:1  
3,1,2,3,7,530,313,600,1,287,312,600,0,1,296,7,9,312,0,1815,1905,True,196,100,sebsi:1  marzouki:1  
3,1,2,3,6,530,357,600,0,243,357,600,0,0,355,1,1,357,0,1815,1930,True,234,121,sebsi:1  marzouki:1  
3,1,2,3,5,530,324,600,0,276,324,600,0,0,317,3,4,324,0,1815,1910,True,208,109,sebsi:1  marzouki:1  
3,1,2,3,4,530,402,600,0,199,401,600,0,1,393,5,3,401,0,1820,1917,False,255,138,sebsi:1  marzouki:1  
3,1,2,3,3,530,384,600,0,217,383,600,0,1,377,4,2,383,0,1815,1915,True,247,130,sebsi:1  marzouki:1  
3,1,2,3,2,530,411,600,1,188,411,600,0,0,406,5,0,411,0,1815,1915,True,304,102,sebsi:1  marzouki:1  
3,1,2,3,1,530,401,599,1,197,401,599,0,0,387,12,2,401,0,1810,1930,True,302,85,sebsi:1  marzouki:1  
3,1,2,2,8,553,379,600,0,221,379,600,0,0,370,7,2,379,0,1830,1930,False,228,142,sebsi:1  marzouki:1  
3,1,2,2,7,559,408,600,1,191,408,600,0,0,399,3,6,408,0,1830,1940,True,254,145,sebsi:1  marzouki:1  
3,1,2,2,6,559,403,600,0,197,403,600,0,0,391,9,3,403,0,1830,1930,False,226,165,sebsi:1  marzouki:1  
3,1,2,2,5,559,460,600,1,139,460,600,0,0,449,7,4,460,0,1830,1930,False,278,171,sebsi:1  marzouki:1  
3,1,2,2,4,559,432,600,0,168,432,600,0,0,423,7,2,432,0,1825,1913,False,282,141,sebsi:1  marzouki:1  
3,1,2,2,3,559,458,600,0,142,458,600,0,0,447,6,5,458,0,1830,1930,True,328,119,sebsi:  marzouki:  
3,1,2,2,2,559,453,600,0,147,453,600,0,0,436,13,4,453,0,1830,1940,True,328,108,sebsi:1  marzouki:1  
3,1,2,2,1,559,460,600,0,140,460,600,0,0,447,11,2,460,0,1830,1925,True,336,111,sebsi:1  marzouki:1  
3,1,1,1,8,570,388,700,0,313,387,700,0,1,369,12,6,387,0,1800,1945,False,281,88,sebsi:  marzouki:  
3,1,1,1,7,576,445,700,0,255,445,700,0,0,436,5,4,445,0,18.54,20.05,True,316,120,sebsi:  marzouki:  
3,1,1,1,6,576,425,700,3,272,425,700,0,0,415,5,5,425,0,18.20,19.25,True,291,124,sebsi:  marzouki:  
3,1,1,1,5,576,487,700,0,213,487,700,0,0,481,2,4,487,0,18.00,19.15,True,343,138,sebsi:  marzouki:  
3,1,1,1,4,576,462,700,1,237,462,700,0,0,458,2,2,462,0,1830,1930,False,320,138,sebsi:0  marzouki:0  
3,1,1,1,3,576,490,700,0,211,489,700,0,1,473,5,11,489,0,1819,1844,True,353,120,sebsi:1  marzouki:1  
3,1,1,1,2,576,474,700,3,223,474,700,0,0,464,4,6,474,0,1815,1930,True,366,98,sebsi:1  marzouki:1  
3,1,1,1,1,576,470,700,1,229,470,700,0,0,454,10,6,470,0,1800,1930,True,373,81,sebsi:1  marzouki:1  
3,4,6,51,1,430,261,500,0,240,261,501,1,0,259,1,1,261,0,1815,1855,True,119,140,sebsi:1  marzouki:1  
3,4,6,50,4,556,219,600,0,381,219,600,0,0,214,4,1,219,0,1820,1913,True,106,108,sebsi:1  marzouki:1  
3,4,6,50,3,556,293,599,0,306,293,599,0,0,285,4,4,293,0,1800,1920,False,120,165,sebsi:1  marzouki:1  
3,4,6,50,2,556,308,600,0,292,308,600,0,0,296,10,2,308,0,1800,1905,False,143,153,sebsi:1  marzouki:1  
3,4,6,50,1,556,368,598,0,230,368,598,0,0,361,3,4,368,0,1815,1850,True,188,173,sebsi:1  marzouki:1  
3,4,5,49,2,309,215,392,0,177,215,392,0,0,209,2,4,215,0,1815,1850,True,129,80,sebsi:1  marzouki:1  
3,4,5,49,1,309,251,401,1,149,251,401,0,0,245,5,1,251,0,1805,1915,False,173,72,sebsi:1  marzouki:1  
3,4,4,48,6,554,378,600,0,222,378,600,0,0,367,5,6,378,0,1825,193,True,180,187,sebsi:1  marzouki:1  
3,4,4,48,5,554,349,600,0,251,349,600,0,0,339,8,2,349,0,1830,1930,True,160,179,sebsi:1  marzouki:1  
3,4,4,48,4,554,431,601,1,169,431,601,0,0,425,6,0,431,0,1830,1940,True,205,220,sebsi:1  marzouki:1  
3,4,4,48,3,554,428,600,0,172,428,600,0,0,417,8,3,428,0,1835,1945,False,228,189,sebsi:1  marzouki:1  
3,4,4,48,1,554,437,600,3,160,437,600,0,0,427,9,1,437,0,1830,1940,True,251,176,sebsi:1  marzouki:1  
3,4,4,47,4,575,370,700,0,331,369,700,0,1,359,5,5,369,0,1830,1915,True,192,167,sebsi:1  marzouki:1  
3,4,4,47,3,576,387,700,0,313,387,700,0,0,379,6,2,387,0,1810,1919,False,190,189,sebsi:1  marzouki:1  
3,4,4,47,2,576,441,702,2,259,441,702,0,0,431,6,4,441,0,1800,1924,True,248,183,sebsi:0  marzouki:1  
3,4,4,47,1,576,466,700,0,234,466,700,0,0,459,6,1,466,0,1825,1915,False,295,164,sebsi:1  marzouki:1  
3,4,4,46,7,558,348,600,0,252,348,600,0,0,340,4,4,348,0,1816,1930,True,144,196,sebsi:0  marzouki:1  
3,4,4,46,6,563,355,600,0,245,355,600,0,0,347,5,3,355,0,1830,1921,True,172,175,sebsi:1  marzouki:1  
3,4,4,46,5,563,365,600,1,234,365,600,0,0,357,7,1,365,0,1820,1907,False,175,182,sebsi:1  marzouki:1  
3,4,4,46,4,563,400,596,0,196,400,596,0,0,392,4,4,400,0,1800,1910,True,175,217,sebsi:1  marzouki:1  
3,4,4,46,3,563,400,600,0,200,400,600,0,0,388,7,5,400,0,1820,1940,True,204,184,sebsi:1  marzouki:1  
3,4,4,46,2,563,437,596,0,159,437,596,0,0,424,9,4,437,0,1800,1950,True,257,167,sebsi:1  marzouki:1  
3,4,4,45,3,426,258,500,0,242,258,500,0,0,252,4,2,258,0,1810,1900,True,113,139,sebsi:1  marzouki:1  
3,4,4,45,2,426,295,504,0,209,295,504,0,0,288,5,2,295,0,1800,1900,True,116,172,sebsi:  marzouki:  
3,4,4,44,3,491,270,600,0,330,270,600,0,0,260,2,8,270,0,1805,1900,False,125,135,sebsi:1  marzouki:1  
3,4,4,44,2,491,331,600,0,269,331,600,0,0,324,5,2,331,0,1818,1914,True,155,169,sebsi:1  marzouki:1  
3,4,4,44,1,491,377,600,1,222,377,600,0,0,369,1,7,377,0,1834,1917,True,207,162,sebsi:1  marzouki:1  
3,4,3,43,5,554,340,600,0,260,340,600,0,0,327,6,7,340,0,,1920,False,122,205,sebsi:1  marzouki:1  
3,4,3,43,4,556,348,600,0,252,348,600,0,0,342,3,3,398,0,1830,1930,True,143,199,sebsi:1  marzouki:1  
3,4,3,43,3,556,409,601,0,192,409,601,0,0,404,2,3,409,0,1830,1950,True,148,256,sebsi:1  marzouki:1  
3,4,3,43,2,556,434,599,0,165,434,599,0,0,428,2,4,434,0,1900,2000,True,180,248,sebsi:1  marzouki:1  
3,4,3,43,1,556,449,600,0,151,449,600,0,0,440,6,3,449,0,1830,2000,True,212,228,sebsi:1  marzouki:1  
3,4,3,42,8,533,298,600,1,301,298,600,0,0,296,1,1,298,0,1830,2000,True,116,180,sebsi:1  marzouki:1  
3,4,3,42,7,540,338,601,0,263,338,601,0,0,322,7,9,338,0,,2015,True,146,176,sebsi:1  marzouki:1  
3,4,3,42,6,540,321,600,0,279,321,600,0,0,314,4,3,321,0,1815,1900,True,156,158,sebsi:1  marzouki:1  
3,4,3,42,5,540,382,600,0,218,382,600,0,0,379,1,2,382,0,1830,1900,True,138,241,sebsi:1  marzouki:1  
3,4,3,42,4,540,388,600,1,211,388,600,0,0,381,5,2,388,0,1825,1935,True,161,220,sebsi:1  marzouki:1  
3,4,3,42,3,540,401,600,1,199,400,600,0,1,393,6,1,400,0,1830,1907,True,194,199,sebsi:1  marzouki:1  
3,4,3,42,2,540,416,600,0,184,416,600,0,0,408,2,6,416,0,1830,1940,False,205,203,sebsi:1  marzouki:1  
3,4,3,42,1,540,432,600,0,168,432,600,0,0,424,5,3,432,0,1825,1925,True,250,174,sebsi:1  marzouki:1  
3,4,2,41,4,500,280,600,0,320,280,600,0,0,270,3,7,280,0,1835,1920,False,116,154,sebsi:1  marzouki:1  
3,4,2,41,3,502,308,600,0,292,308,600,0,0,301,3,4,308,0,1830,1930,True,156,145,sebsi:1  marzouki:1  
3,4,2,41,2,502,378,600,1,221,378,600,0,0,367,6,5,378,0,1835,2000,True,179,188,sebsi:1  marzouki:1  
3,4,2,41,1,502,403,600,1,196,403,600,0,0,398,3,2,403,0,1830,1935,True,238,160,sebsi:1  marzouki:1  
3,4,2,40,6,583,397,701,0,304,397,701,0,0,379,14,4,397,0,1810,1905,True,177,202,sebsi:1  marzouki:1  
3,4,2,40,4,588,420,705,5,280,420,705,0,0,415,2,3,420,0,1815,1915,True,188,227,sebsi:1  marzouki:1  
3,4,2,40,3,588,454,700,1,245,454,700,0,0,449,3,2,454,0,1850,2000,False,231,218,sebsi:1  marzouki:1  
3,4,2,40,2,588,478,700,1,221,478,700,0,0,470,6,2,478,0,1815,1925,True,263,207,sebsi:1  marzouki:1  
3,4,2,40,1,588,479,700,1,220,479,700,0,0,469,3,7,479,0,1815,1920,True,278,191,sebsi:1  marzouki:1  
3,4,2,39,6,588,369,708,0,339,369,708,0,0,358,2,9,369,0,1830,1930,False,181,177,sebsi:1  marzouki:1  
3,4,2,39,5,589,384,700,0,316,384,700,0,0,360,10,14,384,0,1830,1915,False,186,174,sebsi:1  marzouki:1  
3,4,2,39,4,589,438,701,1,262,438,701,0,0,430,3,5,438,0,1820,1915,True,219,211,sebsi:1  marzouki:1  
3,4,2,39,3,589,450,700,0,250,450,700,0,0,440,4,6,450,0,1825,1937,True,215,225,sebsi:1  marzouki:1  
3,4,2,39,2,589,480,700,1,219,480,700,0,0,472,4,4,480,0,1830,1930,True,274,198,sebsi:1  marzouki:1  
3,4,2,39,1,589,479,700,0,221,479,700,0,0,469,5,5,479,0,1820,1950,False,294,175,sebsi:1  marzouki:1  
3,4,2,38,6,560,300,600,1,299,300,600,0,0,291,7,2,300,0,1820,1925,False,130,161,sebsi:1  marzouki:1  
3,4,2,38,5,562,352,600,0,248,352,600,0,0,340,5,7,352,0,1835,1942,False,184,156,sebsi:1  marzouki:1  
3,4,2,38,4,562,387,596,0,209,387,596,0,0,380,5,2,387,0,1830,1930,False,146,234,sebsi:1  marzouki:1  
3,4,2,38,3,562,423,602,2,177,423,602,0,0,418,2,3,423,0,1815,1930,True,207,211,sebsi:1  marzouki:1  
3,4,2,38,2,562,442,600,0,158,442,600,0,0,432,7,3,442,0,1833,2030,True,195,237,sebsi:1  marzouki:1  
3,4,2,38,1,562,448,600,0,152,448,600,0,0,444,3,1,448,0,1845,1925,True,268,176,sebsi:1  marzouki:1  
3,4,1,37,7,560,339,600,0,261,339,600,0,0,331,5,3,339,0,1835,1925,False,183,148,sebsi:1  marzouki:1  
3,4,1,37,6,566,357,600,1,242,357,600,0,0,334,9,14,357,0,1925,2045,True,209,125,sebsi:1  marzouki:1  
3,4,1,37,5,566,394,602,0,208,394,602,0,0,389,2,3,394,0,1835,1940,False,251,138,sebsi:1  marzouki:1  
3,4,1,37,4,566,374,600,0,226,374,600,0,0,366,5,3,374,0,1815,1915,True,201,165,sebsi:1  marzouki:1  
3,4,1,37,3,566,407,601,0,194,407,601,0,0,401,4,2,407,0,1840,1940,False,239,162,sebsi:1  marzouki:1  
3,4,1,37,1,566,434,600,0,166,434,600,0,0,430,2,2,434,0,,1930,False,332,98,sebsi:1  marzouki:1  
3,4,1,36,7,574,341,700,2,357,341,700,0,0,335,4,2,341,0,1825,1945,True,169,166,sebsi:1  marzouki:1  
3,4,1,36,6,576,343,700,0,357,343,700,0,0,331,7,5,343,0,1823,1934,False,153,178,sebsi:1  marzouki:1  
3,4,1,36,5,576,383,700,0,317,383,700,0,0,377,3,3,383,0,1820,1935,False,210,167,sebsi:1  marzouki:1  
3,4,1,36,4,576,360,700,0,340,360,700,0,0,355,2,3,360,0,1820,1930,False,164,191,sebsi:1  marzouki:1  
3,4,1,36,3,576,393,699,1,305,393,699,0,0,390,1,2,393,0,1820,1940,False,205,185,sebsi:1  marzouki:1  
3,4,1,36,2,576,451,702,2,249,451,702,0,0,444,1,6,451,0,1823,2016,False,290,154,sebsi:1  marzouki:1  
3,4,1,36,1,576,448,700,1,251,448,700,0,0,437,8,3,448,0,1819,1935,False,261,176,sebsi:1  marzouki:1  
3,4,1,35,9,546,355,600,0,245,355,600,0,0,352,1,2,355,0,1815,1910,True,187,165,sebsi:1  marzouki:1  
3,4,1,35,8,554,379,600,0,221,379,600,0,0,355,15,9,379,0,1805,1905,True,222,133,sebsi:1  marzouki:1  
3,4,1,35,7,554,380,600,0,220,380,600,0,0,366,8,6,380,0,,1900,True,230,136,sebsi:1  marzouki:1  
3,4,1,35,6,554,419,600,1,180,419,600,0,0,414,1,4,419,0,1800,,True,227,187,sebsi:1  marzouki:1  
3,4,1,35,5,554,438,600,0,162,438,600,0,0,432,4,2,438,0,1800,1855,True,249,183,sebsi:1  marzouki:1  
3,4,1,35,4,554,450,600,2,148,450,600,0,0,435,11,4,450,0,1805,1940,True,254,181,sebsi:1  marzouki:1  
3,6,3,68,3,461,229,501,0,272,229,501,0,0,222,2,5,229,0,1800,1900,True,121,101,sebsi:1  marzouki:1  
3,6,3,68,2,463,278,500,0,222,278,500,0,0,274,2,2,278,0,1806,1915,False,171,103,sebsi:1  marzouki:1  
3,6,3,68,1,463,302,500,0,198,302,500,0,0,288,5,9,312,0,1800,1900,True,210,78,sebsi:1  marzouki:1  
3,6,3,67,1,551,335,599,2,262,335,599,0,0,329,2,4,335,0,1820,1915,True,214,115,sebsi:1  marzouki:1  
3,6,3,66,2,527,309,600,1,290,309,600,0,0,309,1,2,312,3,1845,1925,False,167,139,sebsi:1  marzouki:1  
3,6,3,66,1,528,383,600,0,217,383,600,0,0,375,6,2,383,0,1845,1930,False,245,130,sebsi:1  marzouki:1  
3,6,3,65,4,457,259,500,1,240,259,500,0,0,250,6,3,259,0,,1930,True,161,89,sebsi:1  marzouki:1  
3,6,3,65,3,460,306,500,0,194,306,500,0,0,294,8,4,306,0,1805,1910,False,177,117,sebsi:1  marzouki:1  
3,6,3,65,2,460,333,500,0,167,333,500,0,0,324,3,6,333,0,,1910,True,190,134,sebsi:1  marzouki:0  
3,6,3,65,1,460,357,500,1,142,357,500,0,0,345,7,5,357,0,1820,1940,True,261,84,sebsi:1  marzouki:1  
3,6,2,64,5,525,294,598,1,303,294,598,0,0,278,9,7,294,0,1840,2000,True,126,152,sebsi:1  marzouki:1  
3,6,2,64,4,526,316,600,3,281,316,600,0,0,311,4,1,316,0,2018,2019,False,153,158,sebsi:1  marzouki:1  
3,6,2,64,3,526,364,600,1,235,364,600,0,0,354,7,3,364,0,1820,1940,False,200,154,sebsi:1  marzouki:1  
3,6,2,64,2,526,383,600,0,217,383,600,0,0,376,5,2,383,0,1815,1930,False,233,143,sebsi:1  marzouki:1  
3,6,2,64,1,526,393,600,1,206,393,600,0,0,380,10,3,393,0,1815,1930,True,252,128,sebsi:1  marzouki:1  
3,6,2,63,5,573,334,700,0,366,334,700,0,0,323,5,6,334,0,1845,1935,True,193,130,sebsi:1  marzouki:1  
3,6,2,63,4,577,369,700,2,329,369,700,0,0,363,2,4,369,0,1830,1946,True,200,163,sebsi:1  marzouki:1  
3,6,2,63,3,577,436,700,1,264,435,700,0,1,430,3,2,435,0,1845,2000,False,244,186,sebsi:1  marzouki:1  
3,6,2,63,2,577,439,700,0,261,439,700,0,0,430,6,3,439,0,1840,2020,True,269,161,sebsi:1  marzouki:1  
3,6,2,63,1,577,459,700,0,241,459,700,0,0,443,8,8,459,0,1835,1952,True,314,129,sebsi:1  marzouki:1  
3,6,1,62,7,591,394,700,0,306,394,700,0,0,372,12,10,394,0,1800,1939,True,230,142,sebsi:1  marzouki:1  
3,6,1,62,6,591,370,700,1,329,370,700,0,0,358,6,6,370,0,1830,1942,True,212,146,sebsi:1  marzouki:1  
3,6,1,62,5,591,415,700,0,285,415,700,0,0,408,5,2,415,0,1810,,True,248,160,sebsi:1  marzouki:1  
3,6,1,62,4,591,434,700,0,267,433,700,0,1,427,3,3,433,0,1830,1920,True,242,185,sebsi:1  marzouki:1  
3,6,1,62,3,591,453,701,0,248,453,701,0,0,445,4,4,453,0,1815,1935,True,270,175,sebsi:1  marzouki:1  
3,6,1,62,2,591,490,700,0,210,490,700,0,0,486,2,2,490,0,1820,1915,True,329,157,sebsi:1  marzouki:1  
3,6,1,62,1,591,471,700,2,228,470,700,0,1,465,4,1,470,0,1824,1930,True,345,120,sebsi:1  marzouki:1  
3,5,5,60,1,392,283,500,0,217,283,500,0,0,276,2,5,283,0,,1910,True,176,100,sebsi:0  marzouki:1  
3,5,5,59,3,424,173,500,0,327,173,500,0,0,169,1,3,173,0,1810,1840,True,94,75,sebsi:1  marzouki:1  
3,5,5,59,1,424,289,500,1,210,289,500,0,0,285,4,0,289,0,1800,1900,True,188,97,sebsi:1  marzouki:1  
3,5,4,58,2,547,331,600,0,269,331,600,0,0,320,6,5,331,0,1800,1900,True,159,161,sebsi:1  marzouki:1  
3,5,4,58,1,547,410,600,0,190,410,600,0,0,399,5,6,410,0,1815,1915,True,241,158,sebsi:1  marzouki:1  
3,5,4,57,3,403,251,500,0,249,251,500,0,0,240,6,5,251,0,1815,1905,True,122,118,sebsi:1  marzouki:1  
3,5,4,57,2,405,291,500,1,208,291,500,0,0,286,2,3,291,0,1810,1852,True,157,129,sebsi:1  marzouki:1  
3,5,4,56,4,577,368,700,1,331,368,700,0,0,353,7,8,368,0,1820,1933,False,198,155,sebsi:1  marzouki:1  
3,5,4,56,3,577,399,700,0,301,399,700,0,0,388,4,7,399,0,1803,1930,False,225,163,sebsi:1  marzouki:1  
3,5,4,56,2,577,409,700,2,290,408,700,0,1,396,5,7,408,0,1800,1925,False,236,160,sebsi:1  marzouki:1  
3,5,4,56,1,577,434,700,1,265,434,700,0,0,417,14,3,434,0,1800,1915,False,279,138,sebsi:1  marzouki:1  
3,5,3,55,7,550,337,600,0,263,337,600,0,0,322,11,4,337,0,1805,1900,True,158,164,sebsi:1  marzouki:1  
3,5,3,55,6,550,348,601,1,252,348,601,0,0,340,4,4,348,0,1820,1910,True,185,155,sebsi:1  marzouki:1  
3,5,3,55,5,550,402,600,0,198,402,600,0,0,397,4,1,402,0,1815,1900,True,191,206,sebsi:1  marzouki:1  
3,5,3,55,4,550,413,600,4,183,413,600,0,0,404,8,1,413,0,1800,2000,True,239,165,sebsi:1  marzouki:1  
3,5,3,55,3,550,399,600,0,201,399,600,0,0,393,4,2,399,0,1810,1854,False,219,174,sebsi:1  marzouki:1  
3,5,3,55,2,550,410,600,0,190,410,600,0,0,393,8,9,410,0,1825,1900,True,245,148,sebsi:1  marzouki:1  
3,5,3,55,1,550,412,600,0,188,412,600,0,0,394,8,10,412,0,1800,1910,True,261,133,sebsi:1  marzouki:1  
3,5,2,54,5,550,306,600,1,293,306,600,0,0,293,8,5,306,0,1830,2009,False,164,129,sebsi:1  marzouki:1  
3,5,2,54,4,552,350,600,2,248,350,600,0,0,340,3,7,350,0,1830,2000,False,208,132,sebsi:1  marzouki:1  
3,5,2,54,3,552,368,600,0,232,368,600,0,0,357,5,6,368,0,1815,1930,True,172,185,sebsi:1  marzouki:1  
3,5,2,54,2,552,393,600,0,207,393,600,0,0,383,3,7,393,0,1830,1930,True,246,137,sebsi:1  marzouki:1  
3,5,2,54,1,552,398,600,0,202,398,600,0,0,387,10,1,398,0,1825,1933,True,276,111,sebsi:1  marzouki:1  
3,5,1,53,6,521,326,600,0,274,326,600,0,0,313,9,4,326,0,1800,1945,True,156,157,sebsi:1  marzouki:1  
3,5,1,53,5,524,361,600,1,238,361,600,0,0,356,3,2,361,0,1820,1925,True,175,181,sebsi:1  marzouki:1  
3,5,1,53,4,524,385,600,0,215,385,600,0,0,378,2,5,385,0,,1910,False,179,199,sebsi:1  marzouki:1  
3,5,1,53,3,524,396,600,0,204,396,600,0,0,389,3,4,396,0,1815,1900,True,199,190,sebsi:1  marzouki:1  
3,5,1,53,2,524,417,601,0,184,417,601,0,0,412,3,2,417,0,1815,1935,True,262,150,sebsi:1  marzouki:1  
3,5,1,53,1,524,413,600,1,186,413,600,0,0,403,5,5,413,0,1830,1905,False,258,145,sebsi:1  marzouki:1  
3,5,1,52,4,528,307,600,0,293,307,600,0,0,298,5,4,307,0,1815,1910,True,171,127,sebsi:1  marzouki:1  
3,5,1,52,3,531,357,600,1,242,357,600,0,0,351,5,1,357,0,1817,1903,True,194,157,sebsi:1  marzouki:1  
3,5,1,52,2,531,346,614,1,267,346,614,0,0,340,4,2,346,0,1830,1915,True,193,147,sebsi:1  marzouki:1  
