circonscriptionId,delegationId,subDelegationId,centerID,stationId,registeredVoters,aSigningVoters,bDeliveredBallots,cSpoiledBallots,dLeftBallots,fExtractedBallots,gEplusF,hBminusG,iAminusF,jListVotes,kCancelledVotes,lBlankVotes,mJplusKplusL,nFminusM,countingStart,countingEnd,tampon,sebsi,marzouki,observers
7,8,12,133,1,62,38,101,0,63,38,101,0,0,38,0,0,38,0,1800,1814,True,25,13,sebsi:1  marzouki:1  
7,8,12,132,1,200,113,304,0,191,113,304,0,0,111,2,0,113,0,1814,1850,True,93,18,sebsi:1  marzouki:1  
7,8,11,131,1,133,69,200,0,131,69,200,0,0,63,6,0,69,0,1815,1855,True,35,28,sebsi:  marzouki:  
7,8,11,130,1,76,36,100,0,64,36,100,0,0,34,1,1,36,0,1810,1830,True,24,10,sebsi:  marzouki:  
7,8,10,129,2,374,142,399,0,257,142,399,0,0,135,6,1,142,0,1800,1830,True,64,71,sebsi:  marzouki:  
7,8,10,129,1,375,207,400,0,193,207,400,0,0,200,3,4,207,0,1810,1840,True,137,63,sebsi:  marzouki:  
7,8,9,128,1,204,120,300,0,180,120,300,0,0,119,1,0,120,0,1805,1825,False,91,28,sebsi:  marzouki:  
7,8,9,127,1,242,122,300,1,177,122,300,0,0,115,7,0,122,0,1820,1848,True,89,26,sebsi:  marzouki:  
7,8,9,126,1,220,111,300,0,189,111,300,0,0,104,3,4,111,0,1831,,True,56,48,sebsi:  marzouki:  
7,8,8,125,1,175,77,200,1,122,77,200,0,0,74,3,0,77,0,1815,1845,True,66,8,sebsi:  marzouki:  
7,8,8,124,1,393,148,400,0,252,148,400,0,0,139,7,2,148,0,1820,1845,True,117,22,sebsi:  marzouki:  
7,8,7,123,1,149,84,200,1,115,84,200,0,0,84,0,0,84,0,1810,1830,True,74,10,sebsi:  marzouki:  
7,8,7,122,1,313,126,400,0,274,126,400,0,0,115,9,2,126,0,1805,1850,True,73,42,sebsi:  marzouki:  
7,8,7,121,1,284,106,300,0,194,106,300,0,0,103,1,2,106,0,1800,1820,True,78,25,sebsi:  marzouki:  
7,8,6,120,1,250,149,300,4,147,149,300,0,0,144,5,0,149,0,1800,1840,True,132,12,sebsi:  marzouki:  
7,8,5,119,1,248,110,300,1,189,110,300,0,0,107,1,2,110,0,1800,1823,True,78,29,sebsi:  marzouki:  
7,8,5,118,2,415,150,500,0,350,150,500,0,0,150,0,0,150,0,1805,1840,True,121,29,sebsi:  marzouki:  
7,8,5,118,1,415,241,500,0,259,241,500,0,0,228,4,9,241,0,1815,1930,True,186,42,sebsi:  marzouki:  
7,8,4,117,2,569,327,596,1,268,327,596,0,0,316,6,5,327,0,1820,1915,True,190,126,sebsi:  marzouki:  
7,8,3,115,1,464,315,500,0,185,315,500,0,0,301,10,4,315,0,1800,1855,True,219,82,sebsi:  marzouki:  
7,8,3,114,1,287,175,400,0,225,175,400,0,0,173,2,0,175,0,1810,1830,True,108,65,sebsi:  marzouki:  
7,8,2,113,2,596,336,700,1,363,336,700,0,0,331,3,2,336,0,1815,1935,True,179,152,sebsi:  marzouki:  
7,8,2,113,1,597,431,700,1,268,431,700,0,0,411,11,9,431,0,1830,1911,True,278,133,sebsi:  marzouki:  
7,8,2,112,1,377,223,401,0,178,223,401,0,0,214,5,4,223,0,1830,1900,True,162,52,sebsi:  marzouki:  
7,8,2,111,4,465,237,500,0,263,237,500,0,0,229,5,3,237,0,1807,1908,True,114,115,sebsi:1  marzouki:1  
7,8,2,111,3,465,294,500,0,206,294,500,0,0,289,3,2,294,0,1810,,True,149,140,sebsi:1  marzouki:1  
7,8,2,111,2,465,373,501,0,128,373,501,0,0,362,7,4,373,0,1800,1915,True,237,125,sebsi:1  marzouki:1  
7,8,2,111,1,465,337,500,0,163,337,500,0,0,319,16,2,337,0,1815,1925,True,227,92,sebsi:1  marzouki:1  
7,8,2,110,3,511,295,600,0,305,295,600,0,0,290,4,1,295,0,1810,1845,True,158,132,sebsi:1  marzouki:1  
7,8,2,110,2,513,362,600,0,238,362,600,0,0,357,3,2,362,0,1815,1900,True,205,152,sebsi:1  marzouki:1  
7,8,2,110,1,513,360,600,1,239,360,600,0,0,354,4,2,360,0,1810,1925,True,241,113,sebsi:1  marzouki:1  
7,8,1,109,1,202,80,300,0,220,80,300,0,0,78,2,0,80,0,1810,1850,True,59,19,sebsi:1  marzouki:1  
7,9,7,153,1,297,120,400,0,280,120,400,0,0,115,1,4,120,0,1815,1825,True,84,31,sebsi:1  marzouki:1  
7,9,6,152,1,268,132,300,0,168,132,300,0,0,128,4,0,132,0,1800,1840,True,107,21,sebsi:1  marzouki:1  
7,9,6,151,1,424,192,500,0,308,192,500,0,0,183,7,2,192,0,1805,1838,True,151,32,sebsi:1  marzouki:1  
7,9,5,150,1,399,218,500,0,282,218,500,0,0,205,11,2,218,0,1520,1605,True,188,17,sebsi:1  marzouki:1  
7,9,5,149,1,310,188,400,1,211,188,400,0,0,186,2,0,188,0,1812,1840,True,135,51,sebsi:1  marzouki:1  
7,9,5,148,1,109,55,200,0,145,55,200,0,0,52,3,0,55,0,1810,1830,True,38,14,sebsi:1  marzouki:1  
7,9,4,147,1,158,72,200,0,128,72,200,0,0,70,2,0,72,0,1500,1515,True,64,6,sebsi:1  marzouki:1  
7,9,4,146,1,131,65,200,0,135,65,200,0,0,63,2,0,65,0,1515,1531,True,36,27,sebsi:1  marzouki:1  
7,9,4,145,1,231,113,300,0,187,113,300,0,0,111,2,0,113,0,1810,1840,True,80,31,sebsi:1  marzouki:1  
7,9,3,144,1,235,141,300,0,159,141,300,0,0,136,2,3,141,0,1515,1545,True,117,19,sebsi:1  marzouki:1  
7,9,3,143,1,85,42,200,1,157,42,200,0,0,40,1,1,42,0,1500,1515,True,32,8,sebsi:1  marzouki:1  
7,9,3,142,1,161,82,200,0,118,82,200,0,0,79,2,1,82,0,1510,1530,True,74,5,sebsi:1  marzouki:1  
7,9,3,141,1,185,107,300,0,193,107,300,0,0,104,0,3,107,0,1500,1545,True,79,25,sebsi:1  marzouki:1  
7,9,3,140,1,421,232,500,0,268,232,500,0,0,214,2,16,232,0,1500,1547,True,205,9,sebsi:1  marzouki:1  
7,9,3,139,1,95,39,200,0,161,39,200,0,0,39,0,0,39,0,1800,1820,True,36,3,sebsi:1  marzouki:1  
7,9,2,138,1,99,61,200,0,139,61,200,0,0,60,1,0,61,0,1810,1845,True,58,2,sebsi:1  marzouki:1  
7,9,2,137,1,386,150,500,0,350,150,500,0,0,141,6,3,150,0,1800,1840,True,117,24,sebsi:1  marzouki:1  
7,9,2,136,1,151,66,200,0,134,66,200,0,0,64,0,2,66,0,1800,1830,True,57,7,sebsi:1  marzouki:1  
7,9,1,135,2,426,227,500,0,273,227,500,0,0,216,4,7,227,0,1810,1850,True,169,47,sebsi:1  marzouki:1  
7,9,1,135,1,427,304,500,0,196,304,500,0,0,289,10,5,304,0,1800,1800,True,262,27,sebsi:1  marzouki:1  
7,9,1,134,5,528,257,597,0,340,257,597,0,0,248,3,6,257,0,1800,1845,True,164,84,sebsi:1  marzouki:1  
7,9,1,134,4,530,311,600,0,289,311,600,0,0,306,4,1,311,0,1800,1837,True,223,83,sebsi:1  marzouki:1  
7,9,1,134,3,530,379,600,6,215,379,600,0,0,373,4,2,379,0,1815,1922,True,291,82,sebsi:1  marzouki:1  
7,9,1,134,2,530,368,600,0,232,368,600,0,0,359,4,5,368,0,1800,1851,True,280,79,sebsi:1  marzouki:1  
7,9,1,134,1,530,386,600,0,214,386,600,0,0,375,3,8,386,0,1800,1905,True,306,69,sebsi:1  marzouki:1  
7,11,13,192,1,203,92,300,0,208,92,300,0,0,89,2,1,92,0,1806,1830,True,76,13,sebsi:1  marzouki:1  
7,11,12,191,1,220,88,300,0,212,88,300,0,0,86,2,0,88,0,1805,1832,True,64,22,sebsi:1  marzouki:1  
7,11,12,190,1,191,83,300,2,216,82,300,0,1,80,2,0,82,0,1800,1830,True,57,23,sebsi:1  marzouki:1  
7,11,11,189,2,305,73,400,0,327,73,400,0,0,72,0,1,73,0,1800,,True,51,21,sebsi:1  marzouki:1  
7,11,11,189,1,305,112,400,0,288,112,400,0,0,103,2,7,112,0,1800,1825,True,87,16,sebsi:1  marzouki:1  
7,11,11,188,1,445,131,500,0,369,131,500,0,0,128,2,1,131,0,1800,1840,True,112,16,sebsi:1  marzouki:1  
7,11,10,187,1,228,90,300,0,210,90,300,0,0,87,2,1,90,0,1815,1825,True,85,2,sebsi:1  marzouki:1  
7,11,10,186,1,368,179,400,0,221,179,400,0,0,175,1,3,179,0,1805,,True,154,21,sebsi:1  marzouki:1  
7,11,9,185,1,231,84,300,0,216,84,300,0,0,82,2,0,84,0,1800,1900,True,70,12,sebsi:1  marzouki:1  
7,11,9,184,1,597,266,700,0,434,266,700,0,0,252,10,4,266,0,1830,1933,True,219,33,sebsi:1  marzouki:1  
7,11,9,183,2,335,149,400,0,251,149,400,0,0,146,3,0,149,0,1832,1922,True,125,21,sebsi:1  marzouki:1  
7,11,9,183,1,336,213,400,0,187,213,400,0,0,200,11,2,213,0,1836,1928,True,189,11,sebsi:1  marzouki:1  
7,11,8,182,2,431,246,500,0,254,246,500,0,0,237,1,8,246,0,1800,1840,True,176,61,sebsi:1  marzouki:1  
7,11,8,182,1,432,311,500,0,189,311,500,0,0,289,18,4,311,0,1805,1900,True,231,58,sebsi:1  marzouki:1  
7,11,7,181,1,251,142,300,0,158,142,300,0,0,134,6,2,142,0,1805,1838,True,119,15,sebsi:1  marzouki:1  
7,11,7,180,3,488,198,600,0,402,198,600,0,0,189,6,3,198,0,1809,1837,True,161,28,sebsi:1  marzouki:1  
7,11,7,180,2,488,278,601,0,323,278,601,0,0,269,7,2,278,0,1808,1850,True,234,35,sebsi:1  marzouki:1  
7,11,7,180,1,488,307,600,0,293,307,600,0,0,285,11,11,307,0,1810,1855,True,260,25,sebsi:1  marzouki:1  
7,11,6,179,1,92,18,201,0,183,18,201,0,0,18,0,0,18,0,1802,1810,True,15,3,sebsi:1  marzouki:1  
7,11,5,178,1,348,183,400,0,217,183,400,0,0,173,4,6,183,0,1805,1840,True,153,20,sebsi:1  marzouki:1  
7,11,5,177,1,211,60,300,0,240,60,300,0,0,55,5,0,60,0,1805,1825,True,54,1,sebsi:1  marzouki:1  
7,11,4,176,1,486,154,600,0,446,154,600,0,0,139,15,0,154,0,,1855,True,116,23,sebsi:1  marzouki:1  
7,11,4,175,2,308,116,400,1,283,116,400,0,0,112,3,1,116,0,1800,1837,True,84,28,sebsi:1  marzouki:1  
7,11,4,175,1,309,149,400,1,250,149,400,0,0,141,7,1,149,0,1810,1840,True,125,16,sebsi:1  marzouki:1  
7,11,4,174,1,129,58,200,0,142,58,200,0,0,54,4,0,58,0,1815,1835,True,45,9,sebsi:1  marzouki:1  
7,11,3,173,2,388,123,500,0,377,123,500,0,0,117,6,0,123,0,1810,1845,True,81,36,sebsi:1  marzouki:1  
7,11,3,173,1,389,218,500,1,281,218,500,0,0,211,3,4,218,0,,1836,True,184,27,sebsi:1  marzouki:1  
7,11,2,172,1,108,40,200,0,160,40,200,0,0,35,4,1,40,0,1805,1820,True,33,2,sebsi:1  marzouki:1  
7,11,2,171,1,92,48,201,0,153,48,201,0,0,46,0,2,48,0,1800,1830,True,37,9,sebsi:1  marzouki:1  
7,11,1,170,3,417,222,500,1,277,222,500,0,0,220,2,0,222,0,1806,1845,True,136,84,sebsi:1  marzouki:1  
7,11,1,170,2,417,286,500,0,214,286,500,0,0,275,10,1,286,0,1800,1845,True,201,74,sebsi:1  marzouki:1  
7,11,1,170,1,417,301,497,1,196,300,497,0,1,289,10,1,300,0,1803,1900,True,233,56,sebsi:1  marzouki:1  
7,11,1,169,3,410,236,500,0,264,236,500,0,0,229,7,0,236,0,1800,1845,True,150,79,sebsi:1  marzouki:1  
7,11,1,169,2,411,283,501,0,219,282,501,0,1,278,3,1,282,0,1830,1913,True,208,70,sebsi:1  marzouki:1  
7,11,1,169,1,411,291,501,0,210,291,501,0,0,276,7,8,291,0,1815,1900,True,227,49,sebsi:1  marzouki:1  
7,7,3,108,4,550,330,600,0,270,330,600,0,0,320,8,2,330,0,1805,1925,True,220,100,sebsi:1  marzouki:1  
7,7,3,108,3,551,345,600,1,254,345,600,0,0,338,6,1,345,0,1800,1917,True,235,103,sebsi:1  marzouki:1  
7,7,3,108,2,551,424,600,0,176,424,600,0,0,412,8,4,424,0,1820,1935,True,301,111,sebsi:1  marzouki:1  
7,7,3,108,1,551,430,600,0,170,430,600,0,0,416,7,7,430,0,1810,,True,335,81,sebsi:1  marzouki:1  
7,7,3,107,4,532,325,600,0,275,325,600,0,0,312,9,4,325,0,1800,1910,True,238,74,sebsi:1  marzouki:1  
7,7,3,107,3,533,367,600,0,233,367,600,0,0,361,3,3,367,0,1815,1910,True,291,70,sebsi:1  marzouki:1  
7,7,3,107,2,533,421,600,2,177,421,600,0,0,329,18,14,421,0,1820,1930,True,317,72,sebsi:1  marzouki:1  
7,7,3,107,1,533,386,600,0,214,386,600,0,0,365,20,1,386,0,1800,1940,True,317,48,sebsi:1  marzouki:1  
7,7,3,106,5,511,291,600,1,308,291,600,0,0,280,8,3,291,0,1815,1925,True,212,68,sebsi:1  marzouki:1  
7,7,3,106,4,515,337,600,0,263,337,600,0,0,331,2,4,337,0,1810,1907,True,257,74,sebsi:1  marzouki:1  
7,7,3,106,3,515,391,600,0,209,391,600,0,0,384,4,3,391,0,1800,1901,True,298,86,sebsi:1  marzouki:1  
7,7,3,106,2,515,365,599,4,230,365,599,0,0,356,2,7,365,0,1800,1910,True,304,52,sebsi:1  marzouki:1  
7,7,3,106,1,515,416,600,0,184,416,600,0,0,402,11,3,416,0,1810,1910,True,337,65,sebsi:  marzouki:  
7,7,3,105,4,527,319,600,1,280,319,600,0,0,305,13,1,319,0,1815,1923,True,206,99,sebsi:  marzouki:  
7,7,3,105,3,528,351,600,0,249,351,600,0,0,343,5,3,351,0,1815,1845,True,227,116,sebsi:  marzouki:  
7,7,3,105,2,528,423,600,0,177,423,600,0,0,412,10,1,423,0,1800,1915,True,297,115,sebsi:  marzouki:  
7,7,3,105,1,528,425,600,1,174,425,600,0,0,415,9,1,425,0,1830,,True,320,95,sebsi:  marzouki:  
7,7,3,104,6,562,298,600,1,301,298,600,0,0,279,12,7,298,0,1815,1910,True,183,96,sebsi:  marzouki:  
7,7,3,104,5,567,327,600,0,273,327,600,0,0,320,5,2,327,0,1800,1930,True,230,90,sebsi:  marzouki:  
7,7,3,104,4,567,362,601,0,239,362,601,0,0,348,8,6,362,0,1822,1920,True,253,95,sebsi:1  marzouki:1  
7,7,3,104,3,567,436,600,0,164,436,600,0,0,430,5,1,436,0,1815,1924,True,310,120,sebsi:1  marzouki:1  
7,7,3,104,2,567,362,600,0,238,362,600,0,0,348,8,6,362,0,1815,1940,True,253,95,sebsi:1  marzouki:1  
7,7,3,104,1,567,427,600,2,171,427,600,0,0,410,7,10,427,0,1810,1910,True,328,82,sebsi:  marzouki:  
7,7,2,103,2,599,307,703,0,396,307,703,0,0,300,5,2,307,0,1800,1915,True,268,32,sebsi:  marzouki:  
7,7,2,103,1,599,390,701,0,311,390,701,1,0,371,14,5,390,0,1805,1946,True,322,49,sebsi:  marzouki:  
7,7,2,102,1,207,118,300,0,182,118,300,0,0,116,0,2,118,0,1802,1820,True,84,32,sebsi:  marzouki:  
7,7,2,101,1,40,24,101,0,77,24,101,0,0,24,0,0,24,0,,1515,True,22,2,sebsi:  marzouki:  
7,7,2,100,1,442,251,500,0,249,251,500,0,0,244,2,5,251,0,1807,1859,True,217,27,sebsi:  marzouki:  
7,7,2,99,1,388,253,500,0,247,253,500,0,0,245,7,1,253,0,1815,1847,True,170,75,sebsi:  marzouki:  
7,7,1,98,3,560,337,600,0,263,337,600,0,0,329,7,1,337,0,1830,1900,True,254,75,sebsi:  marzouki:  
7,7,1,98,2,562,432,600,0,168,432,600,0,0,418,6,8,432,0,1820,1905,True,303,115,sebsi:  marzouki:  
7,7,1,98,1,562,451,596,1,144,451,596,0,0,442,9,0,451,0,1820,1920,True,365,77,sebsi:  marzouki:  
7,6,7,97,2,510,291,600,0,309,291,600,0,0,283,4,4,291,0,1805,1920,True,229,54,sebsi:  marzouki:  
7,6,7,97,1,511,373,601,0,228,373,601,0,0,367,4,2,373,0,1813,1910,True,302,65,sebsi:  marzouki:  
7,6,7,96,7,566,362,600,0,238,362,600,0,0,353,6,3,362,0,1815,1915,True,255,98,sebsi:  marzouki:  
7,6,7,96,6,568,354,600,0,246,354,600,0,0,342,9,3,354,0,1815,1930,True,238,104,sebsi:  marzouki:  
7,6,7,96,5,568,388,608,0,220,388,608,0,0,383,2,3,388,0,1830,1905,True,259,124,sebsi:  marzouki:  
7,6,7,96,4,568,446,601,0,155,446,601,0,0,437,9,0,446,0,1800,1900,True,306,131,sebsi:  marzouki:  
7,6,7,96,3,568,471,600,0,129,471,600,0,0,460,6,5,471,0,1800,1915,True,354,106,sebsi:  marzouki:  
7,6,7,96,2,568,416,600,1,183,416,600,0,0,406,8,2,416,0,1830,,True,324,82,sebsi:  marzouki:  
7,6,7,96,1,568,462,600,2,136,462,600,0,0,455,4,3,462,0,1800,1925,True,349,106,sebsi:  marzouki:  
7,6,6,95,1,209,130,300,0,170,130,300,0,0,125,3,2,130,0,1815,1845,True,108,17,sebsi:  marzouki:  
7,6,6,94,2,398,223,500,0,277,223,500,0,0,215,4,4,223,0,1815,1901,True,178,37,sebsi:  marzouki:  
7,6,6,94,1,399,268,500,0,232,268,500,0,0,255,11,2,268,0,1815,,True,210,45,sebsi:  marzouki:  
7,6,6,93,1,405,157,501,0,344,157,501,0,0,147,2,8,157,0,1825,1900,True,119,28,sebsi:  marzouki:  
7,6,6,92,2,351,192,400,0,208,192,400,0,0,189,2,1,192,0,1815,1915,True,161,28,sebsi:  marzouki:  
7,6,6,92,1,352,253,400,0,147,253,400,0,0,250,2,1,253,0,1810,1850,True,214,36,sebsi:  marzouki:  
7,6,5,91,1,30,16,100,0,84,16,100,0,0,16,0,0,16,0,1820,1840,True,13,3,sebsi:  marzouki:  
7,6,5,90,1,351,186,400,0,214,186,400,0,0,183,2,1,186,0,1815,1850,True,139,44,sebsi:  marzouki:  
7,6,5,89,1,208,124,298,0,174,124,298,0,0,124,0,0,124,0,1813,1841,True,101,23,sebsi:  marzouki:  
7,6,5,88,1,333,189,400,0,211,189,400,0,0,188,1,0,189,0,1810,1830,True,141,47,sebsi:  marzouki:  
7,6,5,87,1,237,131,300,0,169,131,300,0,0,126,2,3,131,0,1805,1830,True,90,36,sebsi:  marzouki:  
7,6,4,86,1,245,131,300,0,169,131,300,0,0,130,0,1,131,0,1800,1830,True,111,19,sebsi:  marzouki:  
7,6,4,85,1,576,343,700,0,357,343,700,0,0,335,3,5,343,0,1823,1922,True,284,51,sebsi:  marzouki:  
7,6,4,84,1,226,127,300,0,173,127,300,0,0,118,7,2,127,0,1800,1850,True,94,24,sebsi:  marzouki:  
7,6,4,83,2,373,169,400,0,231,169,400,0,0,161,8,0,169,0,1800,1845,True,138,23,sebsi:  marzouki:  
7,6,4,83,1,373,225,400,0,175,225,400,0,0,215,8,2,225,0,1810,1857,True,201,14,sebsi:  marzouki:  
7,6,4,82,1,318,186,400,2,212,186,400,0,0,184,0,2,186,0,1812,1841,True,139,45,sebsi:  marzouki:  
7,6,3,81,3,441,201,500,1,298,201,500,0,0,195,2,4,201,0,1800,1900,True,149,46,sebsi:  marzouki:  
7,6,3,81,2,442,290,500,0,210,290,500,0,0,285,4,1,290,0,1815,1850,True,241,44,sebsi:  marzouki:  
7,6,3,81,1,442,308,500,2,190,308,500,0,0,294,11,3,308,0,1804,1842,True,256,38,sebsi:  marzouki:  
7,6,3,80,5,547,301,600,0,299,301,600,0,0,292,8,1,301,0,1810,1910,True,238,54,sebsi:  marzouki:  
7,6,3,80,4,551,334,600,0,266,334,600,0,0,323,9,2,334,0,1815,1917,True,263,60,sebsi:  marzouki:  
7,6,3,80,3,551,388,600,0,212,388,600,0,0,382,1,5,388,0,1800,1910,True,299,83,sebsi:  marzouki:  
7,6,3,80,2,551,422,601,1,178,422,601,0,0,409,9,4,422,0,1800,1910,True,342,67,sebsi:  marzouki:  
7,6,3,80,1,551,409,600,0,191,409,600,0,0,395,10,4,409,0,1803,1935,True,351,44,sebsi:  marzouki:  
7,6,2,79,4,578,292,700,0,408,292,700,0,0,283,4,5,292,0,1810,1920,True,198,85,sebsi:  marzouki:  
7,6,2,79,3,579,388,699,0,311,388,699,0,0,380,4,4,388,0,1802,1934,True,287,93,sebsi:1  marzouki:1  
7,6,2,79,2,579,403,700,2,295,403,700,0,0,388,12,3,403,0,1800,1928,True,322,66,sebsi:1  marzouki:1  
7,6,2,79,1,579,414,700,0,286,414,700,0,0,391,22,1,414,0,1807,1910,True,338,53,sebsi:  marzouki:  
7,6,2,78,3,469,295,501,1,206,294,501,0,1,282,6,6,294,0,1820,1920,True,206,76,sebsi:  marzouki:  
7,6,2,78,2,471,346,499,0,153,346,499,0,0,335,9,2,346,0,1810,1915,True,234,101,sebsi:  marzouki:  
7,6,2,78,1,471,371,500,0,129,371,500,0,0,355,11,5,371,0,1801,1900,True,289,66,sebsi:  marzouki:  
7,6,1,77,3,426,239,500,1,260,239,500,0,0,227,7,5,239,0,1800,1900,True,190,37,sebsi:  marzouki:  
7,6,1,77,2,426,321,491,0,170,321,491,0,0,312,5,4,321,0,1830,1930,True,236,76,sebsi:  marzouki:  
7,6,1,77,1,426,335,500,1,164,335,500,0,0,326,7,2,335,0,1815,1920,True,267,59,sebsi:  marzouki:  
7,6,1,76,4,592,371,700,1,328,371,700,0,0,358,10,3,371,0,1833,1954,True,257,101,sebsi:  marzouki:  
7,6,1,76,3,592,416,700,0,284,416,700,0,0,409,4,3,416,0,1812,1934,True,304,105,sebsi:1  marzouki:1  
7,6,1,76,2,592,485,700,0,215,485,700,0,0,468,6,11,485,0,1819,1954,True,386,82,sebsi:1  marzouki:1  
7,6,1,76,1,592,442,700,2,256,442,700,0,0,438,1,3,442,0,1800,1933,True,373,65,sebsi:1  marzouki:1  
7,6,1,75,3,448,260,500,0,240,260,500,0,0,255,2,3,260,0,1800,1847,True,181,74,sebsi:1  marzouki:1  
7,6,1,75,2,448,343,500,1,156,343,500,0,0,337,3,3,343,0,1807,1850,True,257,80,sebsi:1  marzouki:1  
7,6,1,75,1,448,343,500,0,157,343,500,0,0,332,4,7,343,0,1800,1850,True,279,53,sebsi:  marzouki:  
7,10,9,168,1,163,72,200,0,128,72,200,0,0,68,1,3,72,0,1812,1840,True,53,15,sebsi:1  marzouki:1  
7,10,9,167,1,500,284,600,0,316,284,600,0,0,263,10,11,284,0,1818,1907,True,184,79,sebsi:1  marzouki:1  
7,10,8,166,1,230,104,300,0,196,104,300,0,0,99,5,0,104,0,1810,1845,True,68,31,sebsi:1  marzouki:1  
7,10,7,165,1,128,64,200,0,136,64,200,0,0,61,3,0,64,0,1810,1845,True,47,14,sebsi:1  marzouki:1  
7,10,7,164,1,292,115,400,0,285,115,400,0,0,113,2,0,115,0,1802,1830,True,92,21,sebsi:1  marzouki:1  
7,10,6,163,1,322,156,400,1,243,156,400,0,0,150,5,1,156,0,1805,1830,True,119,31,sebsi:1  marzouki:1  
7,10,5,162,1,66,30,100,0,70,30,100,0,0,27,1,2,30,0,1810,1830,True,19,8,sebsi:1  marzouki:1  
7,10,5,161,1,458,243,500,1,256,243,500,0,0,237,3,3,243,0,1806,1840,True,166,71,sebsi:1  marzouki:1  
7,10,4,160,1,163,81,200,0,119,81,200,0,0,79,2,0,81,0,1800,1815,True,58,21,sebsi:1  marzouki:1  
7,10,3,159,1,83,43,200,0,157,43,200,0,0,43,0,0,43,0,1802,1818,True,34,9,sebsi:1  marzouki:1  
7,10,2,158,1,329,199,400,0,201,199,400,0,0,187,10,2,199,0,1800,1914,True,147,40,sebsi:1  marzouki:1  
7,10,1,157,1,120,72,196,0,124,72,196,0,0,71,0,1,72,0,1800,1830,True,44,27,sebsi:1  marzouki:1  
7,10,1,154,2,464,303,500,0,197,303,500,0,0,295,2,6,303,0,1800,1900,True,205,90,sebsi:1  marzouki:1  
7,10,1,154,1,464,311,484,1,172,311,484,0,0,295,14,2,311,0,1815,1904,True,243,52,sebsi:1  marzouki:1  
7,5,4,74,1,156,65,200,0,135,65,200,0,0,65,0,0,65,0,1800,1821,True,44,21,sebsi:1  marzouki:1  
7,5,4,73,1,119,41,200,0,159,41,200,0,0,36,3,2,41,0,1800,1813,True,19,17,sebsi:1  marzouki:1  
7,5,3,72,1,241,152,300,0,148,152,300,0,0,148,2,2,152,0,1800,1845,True,102,46,sebsi:1  marzouki:1  
7,5,3,71,2,366,177,400,0,223,177,400,0,0,174,2,1,177,0,1800,1900,True,138,36,sebsi:1  marzouki:1  
7,5,3,71,1,366,240,400,0,160,240,400,0,0,234,5,1,240,0,1800,1854,True,183,51,sebsi:1  marzouki:1  
7,5,2,70,1,85,43,101,0,58,43,101,0,0,42,1,0,43,0,1805,1826,True,16,26,sebsi:1  marzouki:1  
7,5,2,69,1,148,90,200,0,110,90,200,0,0,88,2,0,90,0,1805,1825,True,55,33,sebsi:1  marzouki:1  
7,5,1,68,2,527,276,600,1,323,276,600,0,0,266,4,6,276,0,1810,1907,True,166,100,sebsi:1  marzouki:1  
7,5,1,68,1,528,321,600,0,279,321,600,0,0,303,16,2,321,0,1807,1915,True,222,81,sebsi:1  marzouki:1  
7,5,1,67,2,499,248,600,1,351,248,600,0,0,242,4,2,248,0,1806,1854,True,151,91,sebsi:1  marzouki:1  
7,5,1,67,1,500,317,600,0,283,317,600,0,0,305,9,3,317,0,1800,1900,True,248,57,sebsi:1  marzouki:1  
7,1,6,13,1,21,9,100,0,91,9,100,0,0,8,1,0,9,0,,1815,True,7,1,sebsi:  marzouki:  
7,1,6,12,1,87,41,100,0,59,41,100,0,0,41,0,0,41,0,1800,1830,True,25,16,sebsi:  marzouki:  
7,1,5,11,1,104,50,200,0,150,50,200,0,0,50,0,0,50,0,1815,1830,True,42,8,sebsi:  marzouki:  
7,1,5,10,1,79,37,100,0,63,37,100,0,0,35,1,1,37,0,1805,1825,True,27,8,sebsi:1  marzouki:1  
7,1,5,9,1,210,105,300,0,195,105,300,0,0,102,3,0,105,0,1815,1850,True,89,13,sebsi:  marzouki:  
7,1,5,8,1,154,82,200,0,118,82,200,0,0,82,0,0,82,0,1800,1812,True,57,25,sebsi:  marzouki:  
7,1,4,7,1,523,298,600,0,302,298,600,0,0,296,0,2,298,0,1820,1905,True,233,63,sebsi:  marzouki:  
7,1,3,6,3,417,179,499,0,320,179,499,0,0,174,4,1,179,0,1811,1850,True,119,55,sebsi:1  marzouki:1  
7,1,3,6,2,419,280,500,0,220,280,500,0,0,269,7,4,280,0,,1815,True,182,87,sebsi:  marzouki:  
7,1,3,6,1,419,263,500,0,237,263,500,0,0,253,6,4,263,0,1800,1900,True,189,64,sebsi:  marzouki:  
7,1,3,5,2,392,186,499,0,313,186,499,0,0,182,4,0,186,0,1810,1900,True,125,57,sebsi:  marzouki:  
7,1,3,5,1,393,233,499,0,266,233,499,0,0,222,9,2,233,0,1800,1849,True,190,32,sebsi:  marzouki:  
7,1,3,4,1,246,140,300,0,160,140,300,0,0,136,2,2,140,0,1805,1837,True,111,25,sebsi:  marzouki:  
7,1,2,3,1,134,73,200,0,127,73,200,0,0,71,2,0,73,0,1815,1845,True,61,10,sebsi:  marzouki:  
7,1,2,2,2,472,235,499,1,263,235,499,0,0,228,3,4,235,0,1810,1905,True,184,44,sebsi:  marzouki:  
7,1,2,2,1,473,329,500,0,171,329,500,0,0,314,11,4,329,0,1830,1900,True,260,54,sebsi:  marzouki:  
7,1,1,1,2,513,257,601,0,344,257,601,0,0,252,3,2,257,0,1810,1900,True,145,107,sebsi:  marzouki:  
7,1,1,1,1,514,346,600,1,253,346,600,0,0,338,6,2,346,0,1830,1920,True,234,104,sebsi:  marzouki:  
7,4,6,66,1,84,46,200,1,153,46,200,0,0,46,0,0,46,0,1810,1830,True,35,11,sebsi:1  marzouki:1  
7,4,6,65,1,97,45,200,0,155,45,200,0,0,45,0,0,45,0,1815,1830,True,39,6,sebsi:  marzouki:  
7,4,6,64,1,174,98,200,0,102,98,200,0,0,91,5,2,98,0,1805,1825,True,47,44,sebsi:  marzouki:  
7,4,6,63,1,434,260,501,0,241,260,501,0,0,254,2,4,260,0,1810,1840,True,162,92,sebsi:  marzouki:  
7,4,3,58,2,330,70,400,0,330,70,400,0,0,69,1,0,70,0,,1830,True,50,19,sebsi:  marzouki:  
7,4,3,58,1,331,137,400,0,263,137,400,0,0,133,1,3,137,0,1800,1843,True,112,21,sebsi:  marzouki:  
7,4,3,57,2,379,107,400,0,293,107,400,0,0,106,0,1,107,0,1800,1830,True,53,53,sebsi:  marzouki:  
7,4,3,57,1,379,208,400,0,192,208,400,0,0,195,13,0,208,0,1800,1845,True,133,62,sebsi:  marzouki:  
7,4,2,56,1,275,89,300,0,211,89,300,0,0,88,0,1,89,0,1808,1830,True,67,21,sebsi:  marzouki:  
7,4,1,55,1,220,126,300,0,174,126,300,0,0,124,1,1,126,0,1801,1840,True,84,40,sebsi:  marzouki:  
7,4,1,54,4,507,86,600,0,514,86,600,0,0,85,0,1,86,0,1800,1837,True,56,29,sebsi:  marzouki:  
7,4,1,54,3,510,191,600,0,409,191,600,0,0,188,3,0,191,0,1822,1910,True,117,71,sebsi:  marzouki:  
7,4,1,54,2,510,218,600,0,382,218,600,0,0,212,5,1,218,0,1821,1908,True,135,77,sebsi:  marzouki:  
7,4,1,54,1,510,280,600,0,320,280,600,0,0,267,6,7,280,0,1800,1850,True,185,82,sebsi:  marzouki:  
7,4,1,53,3,558,290,601,0,312,289,601,0,1,281,7,1,289,0,1830,1925,True,153,128,sebsi:  marzouki:  
7,4,1,53,2,558,424,600,0,176,424,600,0,0,414,5,5,424,0,1821,1920,True,243,171,sebsi:  marzouki:  
7,4,1,53,1,558,401,595,0,194,401,595,0,0,380,7,14,401,0,1835,1915,True,271,109,sebsi:  marzouki:  
7,2,9,36,1,97,52,200,0,148,52,200,0,0,51,1,0,52,0,,1825,True,44,7,sebsi:  marzouki:  
7,2,9,35,1,109,47,199,1,151,47,199,0,0,45,2,0,47,0,1800,1830,True,38,7,sebsi:  marzouki:  
7,2,9,34,1,288,115,401,0,286,115,401,0,0,109,5,1,115,0,1800,1835,True,98,11,sebsi:  marzouki:  
7,2,8,33,1,183,85,200,0,115,85,200,0,0,79,5,1,85,0,1809,1840,True,64,15,sebsi:  marzouki:  
7,2,7,32,1,386,128,500,0,372,128,500,0,0,122,4,2,128,0,1800,1817,True,101,21,sebsi:  marzouki:  
7,2,7,31,1,152,66,196,0,130,66,196,0,0,60,6,0,66,0,1805,1835,True,51,9,sebsi:  marzouki:  
7,2,6,30,1,84,48,200,0,152,48,200,0,0,46,1,1,48,0,1800,1830,True,35,11,sebsi:  marzouki:  
7,2,6,29,1,291,150,400,1,249,150,400,0,0,145,1,4,150,0,1810,1900,True,104,41,sebsi:  marzouki:  
7,2,6,28,1,169,100,202,0,102,108,202,0,0,99,1,0,100,0,1815,1828,True,79,20,sebsi:  marzouki:  
7,2,5,27,1,554,332,600,4,264,332,600,0,0,317,15,0,332,0,1900,2000,True,242,75,sebsi:  marzouki:  
7,2,4,26,1,194,102,300,0,198,102,300,0,0,98,4,0,102,0,1830,1900,True,76,22,sebsi:  marzouki:  
7,2,4,25,1,486,198,600,0,402,198,600,0,0,186,10,2,198,0,1820,1906,True,144,42,sebsi:  marzouki:  
7,2,4,24,1,190,102,300,0,198,102,300,0,0,94,8,0,102,0,1801,1842,True,76,18,sebsi:  marzouki:  
7,2,3,23,1,147,87,200,0,113,87,200,0,0,85,0,2,87,0,1800,1830,True,57,28,sebsi:  marzouki:  
7,2,2,18,2,530,369,592,1,222,369,592,0,0,362,5,2,369,0,1845,1920,True,246,116,sebsi:  marzouki:  
7,2,2,18,1,530,394,600,12,194,394,600,0,0,375,13,6,394,0,1812,1903,True,301,74,sebsi:  marzouki:  
7,2,1,17,1,552,325,600,4,271,325,600,0,0,311,11,3,325,0,1800,1935,True,214,97,sebsi:  marzouki:  
7,2,1,16,2,457,285,500,0,215,285,500,0,0,273,10,2,285,0,1819,1915,True,173,100,sebsi:  marzouki:  
7,2,1,16,1,457,347,500,0,153,347,500,0,0,341,4,2,347,0,1815,1915,True,254,87,sebsi:  marzouki:  
7,2,1,15,2,512,279,600,0,321,279,600,0,0,274,4,1,279,0,1800,1855,True,198,76,sebsi:  marzouki:  
7,2,1,15,1,512,358,600,0,242,358,600,0,0,344,7,7,358,0,1825,1919,True,276,68,sebsi:  marzouki:  
7,2,1,14,4,531,266,600,0,334,266,600,0,0,255,8,3,266,0,1810,1915,True,172,83,sebsi:  marzouki:  
7,2,1,14,3,532,364,600,0,236,364,600,0,0,357,3,4,364,0,1810,1900,True,243,114,sebsi:  marzouki:  
7,2,1,14,2,532,401,600,2,196,401,600,0,0,375,19,7,401,0,1800,,True,268,107,sebsi:  marzouki:  
7,2,1,14,1,532,403,600,0,197,403,600,0,0,378,6,19,403,0,1820,1910,True,308,70,sebsi:  marzouki:  
