circonscriptionId,delegationId,subDelegationId,centerID,stationId,registeredVoters,aSigningVoters,bDeliveredBallots,cSpoiledBallots,dLeftBallots,fExtractedBallots,gEplusF,hBminusG,iAminusF,jListVotes,kCancelledVotes,lBlankVotes,mJplusKplusL,nFminusM,countingStart,countingEnd,tampon,sebsi,marzouki,observers
9,2,8,21,2,373,202,400,1,197,202,400,0,0,200,0,2,202,0,18.15,18.45,True,100,100,sebsi:1  marzouki:1  
9,2,8,21,1,374,276,400,0,124,276,400,0,0,271,3,2,276,0,18.30,19.13,True,134,137,sebsi:1  marzouki:1  
9,2,7,19,1,484,311,600,0,289,311,600,0,0,302,5,4,311,0,18.15,18.50,True,143,159,sebsi:1  marzouki:1  
9,2,6,18,1,135,73,200,0,127,73,200,0,0,71,1,1,73,0,18.10,18.30,True,63,8,sebsi:1  marzouki:1  
9,2,4,15,1,492,308,600,0,292,308,600,0,0,303,4,1,308,0,18.20,18.55,False,196,107,sebsi:1  marzouki:1  
9,2,3,14,1,254,135,300,0,165,135,300,0,0,131,3,1,135,0,18.21,19.13,True,91,40,sebsi:1  marzouki:1  
9,2,3,13,1,447,246,500,1,253,246,500,0,0,238,7,1,246,0,18.20,19.15,True,181,57,sebsi:1  marzouki:1  
9,2,2,12,2,549,289,600,0,311,289,600,0,0,285,3,1,289,0,18.10,18.50,True,119,166,sebsi:1  marzouki:1  
9,2,2,12,1,550,397,599,0,202,397,599,0,0,387,6,4,397,0,18.15,19.07,True,206,181,sebsi:1  marzouki:1  
9,2,1,11,4,455,207,501,0,294,207,501,0,0,200,7,0,207,0,1805,1900,False,120,80,sebsi:1  marzouki:1  
9,2,1,11,3,457,257,500,0,243,257,500,0,0,252,2,3,257,0,18.20,19.15,True,181,71,sebsi:1  marzouki:1  
9,2,1,11,2,457,324,492,0,168,324,492,0,0,315,4,5,324,0,18.30,19.30,True,229,86,sebsi:1  marzouki:1  
9,2,1,11,1,457,321,501,0,180,321,501,0,0,313,6,2,321,0,18.10,19.15,False,248,65,sebsi:1  marzouki:1  
9,5,3,66,2,402,162,500,0,338,162,500,0,0,158,3,1,162,0,18.10,19.05,False,86,72,sebsi:1  marzouki:1  
9,5,3,66,1,403,265,500,1,234,265,500,0,0,246,16,3,265,0,18.30,,True,170,76,sebsi:1  marzouki:1  
9,5,2,65,1,441,294,500,0,206,294,500,0,0,290,2,2,294,0,18.30,19.30,True,210,80,sebsi:1  marzouki:1  
9,5,2,64,5,497,295,600,1,304,295,600,0,0,286,3,6,295,0,18.22,19.16,False,163,123,sebsi:1  marzouki:1  
9,5,2,64,4,600,246,600,0,354,246,600,0,0,243,3,0,246,0,18.15,19.15,False,143,100,sebsi:1  marzouki:1  
9,5,2,64,3,500,353,600,0,247,353,600,0,0,349,2,2,353,0,18.20,19.30,True,209,140,sebsi:1  marzouki:1  
9,5,2,64,2,500,382,600,0,218,382,600,0,0,371,5,6,382,0,18.28,19.53,True,252,119,sebsi:1  marzouki:1  
9,5,2,64,1,500,373,600,1,226,373,600,0,0,362,5,6,373,0,18.15,19.20,False,257,105,sebsi:1  marzouki:1  
9,5,2,63,2,342,194,394,2,198,194,394,0,0,189,5,0,194,0,,,True,134,55,sebsi:1  marzouki:1  
9,5,2,63,1,343,254,396,1,142,253,396,0,1,248,4,1,253,0,18.45,20.05,True,169,79,sebsi:1  marzouki:1  
9,5,1,62,5,509,269,599,1,330,268,599,0,1,258,8,2,268,0,18.30,19.22,True,148,110,sebsi:1  marzouki:1  
9,5,1,62,4,513,263,596,1,332,263,596,0,0,256,5,2,263,0,18.20,19.00,False,150,106,sebsi:1  marzouki:1  
9,5,1,62,3,513,334,600,0,266,334,600,0,0,330,4,0,334,0,18.00,,False,210,120,sebsi:1  marzouki:1  
9,5,1,62,2,513,350,600,2,249,349,600,0,1,343,5,1,349,0,18.20,19.36,True,241,102,sebsi:1  marzouki:1  
9,5,1,62,1,513,363,600,1,237,362,600,0,1,349,10,3,362,0,18.35,19.57,True,269,80,sebsi:1  marzouki:1  
9,5,1,61,5,487,253,600,0,347,253,600,0,0,247,3,3,253,0,18.30,19.30,True,131,116,sebsi:1  marzouki:1  
9,5,1,61,4,490,281,600,0,319,281,600,0,0,275,4,2,281,0,18.21,19.11,False,157,118,sebsi:  marzouki:  
9,5,1,61,3,490,359,600,0,241,359,600,0,0,352,4,3,359,0,06.30,19.45,False,211,141,sebsi:1  marzouki:1  
9,5,1,61,2,490,337,600,0,263,337,600,0,0,324,9,4,337,0,,19.38,True,214,110,sebsi:1  marzouki:1  
9,5,1,61,1,490,371,600,0,229,371,600,0,0,355,5,11,371,0,18.30,19.30,False,268,87,sebsi:1  marzouki:1  
9,9,8,142,1,478,197,600,0,403,197,600,0,0,190,4,3,197,0,18.15,19.00,True,148,42,sebsi:1  marzouki:0  
9,9,8,140,1,541,234,600,0,366,234,600,0,0,218,16,0,234,0,18.15,19.15,True,167,51,sebsi:1  marzouki:0  
9,9,7,139,1,357,151,400,0,249,151,400,0,0,147,2,2,151,0,18.15,18.41,True,109,38,sebsi:1  marzouki:0  
9,9,7,138,1,237,118,300,0,182,118,300,0,0,115,2,1,118,0,18.30,19.30,False,90,25,sebsi:1  marzouki:0  
9,9,7,137,2,311,82,400,0,318,82,400,0,0,80,2,0,82,0,18.05,18.40,True,39,41,sebsi:1  marzouki:0  
9,9,7,137,1,311,202,400,1,197,202,400,0,0,198,1,3,202,0,18.30,19.00,True,131,67,sebsi:  marzouki:  
9,9,6,136,1,266,143,300,0,157,143,300,0,0,139,4,0,143,0,18.15,18.30,True,107,32,sebsi:  marzouki:  
9,9,6,135,1,326,166,400,0,234,166,400,0,0,164,0,2,166,0,18.00,18.20,False,133,31,sebsi:  marzouki:  
9,9,6,134,1,384,168,500,1,331,168,500,0,0,166,1,1,168,0,18.05,18.45,False,127,39,sebsi:  marzouki:  
9,9,6,133,2,335,120,400,0,280,120,400,0,0,114,5,1,120,0,18.20,18.35,False,72,42,sebsi:  marzouki:  
9,9,6,133,1,336,222,400,1,177,222,400,0,0,206,15,1,222,0,18.10,18.45,True,140,66,sebsi:  marzouki:  
9,9,6,132,1,234,85,300,0,215,85,300,0,0,83,1,1,85,0,18.15,18.40,False,66,17,sebsi:1  marzouki:1  
9,9,5,131,1,454,256,500,1,243,256,500,0,0,247,9,0,256,0,18.20,19.10,True,177,70,sebsi:1  marzouki:1  
9,9,5,130,2,381,141,200,1,58,141,200,0,0,139,2,0,141,0,18.10,18.40,True,79,60,sebsi:1  marzouki:1  
9,9,5,130,1,382,220,500,0,280,220,500,0,0,212,6,2,220,0,,07.00,True,164,48,sebsi:1  marzouki:1  
9,9,5,129,1,176,109,200,0,91,109,200,0,0,104,3,2,109,0,18.15,18.42,True,64,40,sebsi:1  marzouki:1  
9,9,5,128,2,342,138,400,0,262,138,400,0,0,136,2,0,138,0,18.10,18.35,False,89,47,sebsi:1  marzouki:1  
9,9,5,128,1,342,199,400,0,201,199,400,0,0,191,7,1,199,0,15.00,19.00,True,137,54,sebsi:1  marzouki:1  
9,9,4,127,1,167,109,200,0,91,109,200,0,0,104,2,3,109,0,18.30,19.00,True,80,24,sebsi:1  marzouki:1  
9,9,4,126,2,406,77,503,0,426,77,503,0,0,76,0,1,77,0,18.10,18.45,True,63,13,sebsi:1  marzouki:1  
9,9,4,126,1,407,247,504,0,257,247,504,0,0,237,2,8,247,0,18.15,19.00,True,203,34,sebsi:1  marzouki:1  
9,9,4,125,2,349,92,400,0,308,92,400,0,0,89,1,2,92,0,18.30,19.00,True,42,47,sebsi:1  marzouki:1  
9,9,4,125,1,350,179,400,0,221,179,400,0,0,173,1,5,179,0,18.15,19.00,True,117,56,sebsi:1  marzouki:1  
9,9,3,124,1,445,193,501,0,308,193,501,0,0,189,4,0,193,0,18.00,19.00,True,150,39,sebsi:1  marzouki:1  
9,9,3,123,1,457,267,501,0,234,267,501,0,0,263,3,1,267,0,18.00,,True,218,45,sebsi:1  marzouki:1  
9,9,2,120,1,342,220,400,4,176,220,400,0,0,209,7,4,220,0,18.30,18.52,False,187,22,sebsi:1  marzouki:0  
9,9,1,117,1,395,192,500,0,308,192,500,0,0,183,7,2,192,0,18.10,19.00,True,144,39,sebsi:1  marzouki:1  
9,9,1,116,1,275,176,300,1,123,176,300,0,0,172,3,1,176,0,06.00,07.00,True,134,38,sebsi:1  marzouki:1  
9,9,1,115,7,522,233,600,0,367,233,600,0,0,223,8,2,233,0,18.15,19.15,True,135,88,sebsi:1  marzouki:1  :  
9,9,1,115,6,523,269,600,0,331,269,600,0,0,260,8,1,269,0,1815,1850,True,199,61,sebsi:1  marzouki:1  
9,9,1,115,5,523,288,600,0,312,288,600,0,0,276,10,2,288,0,18.13,19.00,True,196,80,sebsi:1  marzouki:1  :  
9,9,1,115,3,523,399,600,0,201,399,600,0,0,386,10,3,399,0,18.15,17.30,False,285,101,sebsi:1  marzouki:1  
9,9,1,115,2,523,355,600,2,243,355,600,0,0,338,4,13,355,0,18.30,19.55,False,284,54,sebsi:1  marzouki:1  
9,9,1,115,1,523,409,596,0,187,409,596,0,0,388,21,0,409,0,,19.15,False,330,58,sebsi:1  marzouki:1  
9,8,6,114,2,443,211,497,0,286,211,497,0,0,206,2,3,211,0,18.10,18.39,True,77,129,sebsi:1  marzouki:1  
9,8,6,114,1,444,274,500,0,226,274,500,0,0,262,2,10,274,0,18.15,19.00,True,119,143,sebsi:1  marzouki:1  
9,8,5,113,1,87,50,100,0,50,50,100,0,0,49,0,1,50,0,18.50,19.30,True,39,10,sebsi:1  marzouki:1  
9,8,5,112,2,405,174,500,0,326,174,500,0,0,170,3,1,174,0,18.45,19.15,True,82,88,sebsi:1  marzouki:1  
9,8,5,112,1,406,235,501,0,266,235,501,0,0,230,2,3,235,0,18.45,19.30,False,166,64,sebsi:1  marzouki:1  
9,8,5,111,2,505,290,600,0,310,290,600,0,0,283,5,2,290,0,18.40,19.30,True,112,171,sebsi:1  marzouki:1  
9,8,5,111,1,505,320,600,0,280,320,600,0,0,312,5,3,320,0,18.15,19.00,False,163,149,sebsi:1  marzouki:1  
9,8,5,110,4,531,274,600,1,325,274,600,0,0,267,2,5,274,0,18.25,19.05,True,117,150,sebsi:1  marzouki:1  
9,8,5,110,2,533,353,594,0,241,353,594,0,0,348,3,2,353,0,18.30,19.20,False,201,147,sebsi:1  marzouki:1  
9,8,5,110,1,533,345,595,1,249,345,595,0,0,340,3,2,345,0,18.20,19.10,True,237,103,sebsi:1  marzouki:1  
9,8,4,109,3,440,226,500,0,274,226,500,0,0,212,7,7,226,0,18.30,19.15,True,124,88,sebsi:1  marzouki:1  
9,8,4,109,2,440,273,500,0,227,273,500,0,0,271,1,1,273,0,18.25,19.00,True,175,96,sebsi:1  marzouki:1  
9,8,4,109,1,440,270,501,1,230,270,501,0,0,263,7,0,270,0,18.30,19.10,True,190,73,sebsi:1  marzouki:1  
9,8,3,108,1,575,396,700,3,301,396,700,0,0,388,5,3,396,0,18.30,19.45,True,269,119,sebsi:1  marzouki:1  
9,8,3,107,3,548,389,608,1,219,388,608,0,1,377,4,7,388,0,18.30,20.01,True,231,146,sebsi:1  marzouki:1  
9,8,3,107,2,548,427,600,0,173,427,600,0,0,416,10,1,427,0,18.25,19.40,True,269,147,sebsi:1  marzouki:1  
9,8,3,107,1,548,423,594,1,170,423,594,0,0,409,6,8,423,0,18.25,19.24,True,292,117,sebsi:1  marzouki:1  
9,8,3,106,5,529,295,603,0,308,295,603,0,0,286,3,6,295,0,18.25,19.20,True,144,142,sebsi:1  marzouki:1  
9,8,3,106,4,531,335,601,1,265,335,601,0,0,325,4,6,335,0,18.35,19.31,True,193,132,sebsi:1  marzouki:1  
9,8,3,106,3,531,400,600,0,200,400,600,0,0,391,5,4,400,0,18.00,19.00,True,248,143,sebsi:1  marzouki:1  
9,8,3,106,2,531,376,600,0,224,376,600,0,0,366,8,2,376,0,18.30,19.51,True,236,130,sebsi:1  marzouki:1  
9,8,3,106,1,531,381,599,0,218,381,599,0,0,368,4,9,381,0,18.20,20.00,True,257,111,sebsi:1  marzouki:1  
9,8,2,105,4,474,251,500,0,249,251,500,0,0,245,5,1,251,0,18.32,19.20,False,105,140,sebsi:1  marzouki:1  
9,8,2,105,3,475,277,501,0,224,277,501,0,0,271,5,1,277,0,18.30,19.35,True,135,136,sebsi:1  marzouki:1  
9,8,2,105,2,475,320,500,1,179,320,500,0,0,311,5,4,320,0,18.30,19.30,True,161,150,sebsi:1  marzouki:1  
9,8,2,103,3,491,343,600,0,257,343,600,0,0,336,7,0,343,0,,19.30,True,174,162,sebsi:1  marzouki:1  :  
9,8,2,103,2,491,371,600,0,229,371,600,0,0,364,5,2,371,0,18.45,20.00,True,187,177,sebsi:1  marzouki:1  :  
9,8,2,103,1,491,363,600,0,237,363,600,0,0,355,3,5,363,0,18.45,19.40,False,207,148,sebsi:1  marzouki:1  :  
9,8,1,102,2,572,354,700,0,346,354,700,0,0,344,7,3,354,0,16.35,19.30,True,168,176,sebsi:1  marzouki:1  :  
9,8,1,102,1,573,423,701,0,278,423,701,0,0,415,1,7,423,0,18.30,19.30,False,265,150,sebsi:1  marzouki:1  :  
9,8,1,101,4,565,343,600,0,257,343,600,0,0,334,7,2,343,0,18.33,19.33,False,144,190,sebsi:1  marzouki:1  :  
9,8,1,101,3,566,365,600,0,235,365,600,0,0,360,3,2,365,0,18.30,19.35,False,173,187,sebsi:1  marzouki:1  :  
9,8,1,101,2,566,436,600,0,164,436,600,0,0,427,5,4,436,0,18.30,19.45,False,256,171,sebsi:1  marzouki:1  :  
9,8,1,101,1,566,418,600,0,182,418,600,0,0,407,7,4,418,0,18.35,19.55,False,264,143,sebsi:1  marzouki:1  :  
9,8,1,100,6,600,379,700,0,321,379,700,0,0,364,10,5,379,0,18.50,20.00,True,176,188,sebsi:1  marzouki:1  :  
9,8,1,100,5,600,342,700,1,357,342,700,0,0,338,1,3,342,0,18.45,20.00,False,156,182,sebsi:1  marzouki:1  :  
9,8,1,100,4,600,427,699,0,272,427,699,0,0,421,3,3,427,0,19.00,20.18,True,189,232,sebsi:1  marzouki:1  :  
9,8,1,100,3,600,466,696,0,230,466,696,0,0,453,9,4,466,0,18.45,19.20,False,258,195,sebsi:1  marzouki:1  :  
9,8,1,100,2,600,470,700,1,229,470,700,0,0,452,12,6,470,0,18.35,19.55,False,267,185,sebsi:1  marzouki:1  :  
9,8,1,100,1,600,469,700,3,228,469,700,0,0,458,8,3,469,0,18.50,19.40,True,298,160,sebsi:1  marzouki:1  :  
9,8,1,99,6,514,350,600,0,250,350,600,0,0,340,7,3,350,0,18.33,19.15,True,168,172,sebsi:1  marzouki:1  :  
9,8,1,99,5,516,355,600,0,245,355,600,0,0,346,6,3,355,0,18.42,19.41,True,191,155,sebsi:1  marzouki:1  :  
9,8,1,99,3,516,385,600,0,215,385,600,0,0,378,5,2,385,0,16.45,19.45,True,197,181,sebsi:1  marzouki:1  
9,8,1,99,2,516,418,603,0,185,418,603,0,0,408,5,5,418,0,18.50,20.05,True,243,165,sebsi:1  marzouki:1  
9,8,1,99,1,516,424,601,7,170,424,601,0,0,414,5,5,424,0,19.15,20.45,True,291,123,sebsi:1  marzouki:1  
9,12,1,168,5,560,297,600,1,302,297,600,0,0,293,1,3,297,0,18.20,19.15,True,170,123,sebsi:1  marzouki:1  
9,12,1,168,4,560,364,600,0,236,364,600,0,0,358,4,2,364,0,18.30,19.15,True,231,127,sebsi:1  marzouki:1  
9,7,9,98,1,285,143,300,0,157,143,300,0,0,137,5,1,143,0,18.20,19.20,True,87,50,sebsi:1  marzouki:1  
9,7,9,97,1,205,92,300,0,208,92,300,0,0,90,0,2,92,0,06.15,07.00,False,63,27,sebsi:1  marzouki:1  
9,7,8,96,1,207,105,300,0,195,105,300,0,0,100,4,1,105,0,18.05,18.22,True,71,29,sebsi:1  marzouki:1  
9,7,8,95,2,366,108,400,0,292,108,400,0,0,106,0,2,108,0,,,False,80,26,sebsi:1  marzouki:1  
9,7,8,95,1,367,220,401,1,180,220,401,0,0,207,9,4,220,0,18.15,19.20,False,158,49,sebsi:1  marzouki:1  
9,7,8,94,2,314,104,400,0,296,104,400,0,0,101,3,0,104,0,18.00,18.40,True,83,18,sebsi:1  marzouki:1  
9,7,8,94,1,314,189,400,1,210,189,400,0,0,181,8,0,189,0,18.15,19.00,False,150,31,sebsi:1  marzouki:1  :  
9,7,8,93,3,483,170,600,0,430,170,600,0,0,166,3,1,170,0,19.00,,False,105,61,sebsi:1  marzouki:1  :  
9,7,8,93,2,484,253,600,0,347,253,600,0,0,247,4,2,253,0,18.00,19.00,False,170,77,sebsi:1  marzouki:1  :  
9,7,8,93,1,484,326,601,0,275,326,601,0,0,312,9,5,326,0,06.15,19.05,False,236,76,sebsi:1  marzouki:0  
9,7,7,92,1,279,163,300,0,137,163,300,0,0,158,3,2,163,0,18.05,18.30,True,128,30,sebsi:1  marzouki:0  
9,7,7,91,1,240,122,300,0,178,122,300,0,0,116,3,3,122,0,18.05,19.00,False,87,29,sebsi:1  marzouki:1  
9,7,7,90,2,412,122,501,0,379,122,501,0,0,120,2,0,122,0,18.10,18.30,True,94,26,sebsi:1  marzouki:1  
9,7,7,90,1,413,219,501,0,282,219,501,0,0,206,10,3,219,0,18.00,18.53,True,175,31,sebsi:1  marzouki:0  
9,7,6,89,1,71,49,100,1,50,49,100,0,0,49,0,0,49,0,18.15,18.27,True,36,13,sebsi:1  marzouki:0  
9,7,6,88,1,116,54,200,0,146,54,200,0,0,51,3,0,54,0,18.10,18.26,True,41,10,sebsi:  marzouki:  
9,7,6,87,1,123,73,200,0,127,73,200,0,0,72,1,0,73,0,18.15,18.42,True,46,26,sebsi:  marzouki:  
9,7,5,86,1,69,27,100,0,73,27,100,0,0,26,0,1,27,0,18.00,18.25,True,19,7,sebsi:  marzouki:  
9,7,5,85,1,321,142,400,0,258,142,400,0,0,141,1,0,142,0,18.30,19.00,False,99,42,sebsi:  marzouki:  
9,7,5,84,1,271,111,300,0,189,111,300,0,0,106,5,0,111,0,18.10,18.40,True,73,33,sebsi:1  marzouki:1  
9,7,4,83,1,97,63,200,0,137,63,200,0,0,58,4,1,63,0,18.05,18.44,True,50,8,sebsi:1  marzouki:1  
9,7,4,82,1,85,53,96,0,43,53,96,0,0,53,0,0,53,0,18.25,18.45,True,35,18,sebsi:  marzouki:  
9,7,4,81,1,323,159,400,1,240,159,400,0,0,150,8,1,159,0,06.15,07.00,False,130,20,sebsi:1  marzouki:1  
9,7,4,80,1,243,95,300,0,205,95,300,0,0,93,1,1,95,0,18.15,18.50,False,68,25,sebsi:1  marzouki:1  
9,7,3,79,1,431,217,500,0,283,217,500,0,0,212,4,1,217,0,18.15,19.00,False,146,66,sebsi:1  marzouki:1  
9,7,2,78,1,124,63,200,0,137,63,200,0,0,57,6,0,63,0,1805,1831,False,37,20,sebsi:1  marzouki:0  
9,7,2,77,1,98,50,200,0,150,50,200,0,0,47,3,0,50,0,18.00,18.30,True,36,11,sebsi:1  marzouki:1  
9,7,2,76,2,404,196,500,1,303,196,500,0,0,192,2,2,196,0,18.40,18.41,True,119,73,sebsi:1  marzouki:1  
9,7,2,76,1,405,251,498,0,247,251,498,0,0,238,12,1,251,0,18.30,18.45,False,187,51,sebsi:1  marzouki:1  
9,7,1,75,2,363,139,400,0,261,139,400,0,0,131,8,0,139,0,18.15,18.45,True,70,61,sebsi:1  marzouki:1  
9,7,1,75,1,364,236,400,0,164,236,400,0,0,230,6,0,236,0,18.45,19.00,True,156,74,sebsi:1  marzouki:1  
9,7,1,74,2,326,127,400,0,273,127,400,0,0,119,7,1,127,0,18.15,18.30,False,93,26,sebsi:1  marzouki:1  
9,7,1,74,1,327,201,400,0,199,201,400,0,0,191,6,4,201,0,18.00,18.30,False,147,44,sebsi:1  marzouki:1  
9,7,1,73,1,329,130,400,0,270,130,400,0,0,124,4,2,130,0,18.20,18.50,True,94,30,sebsi:1  marzouki:1  
9,6,4,72,4,562,261,600,0,339,261,600,0,0,248,4,9,261,0,18.23,19.00,True,92,156,sebsi:1  marzouki:1  
9,6,4,72,3,564,290,600,0,310,290,600,0,0,288,1,1,290,0,18.20,18.55,True,141,147,sebsi:1  marzouki:1  
9,6,4,72,2,564,395,600,1,204,395,600,0,0,389,3,3,395,0,18.15,19.10,True,187,202,sebsi:1  marzouki:1  
9,6,4,72,1,564,412,598,1,186,411,598,0,1,390,11,10,411,0,18.25,19.15,True,223,167,sebsi:1  marzouki:1  
9,6,4,71,2,305,165,400,0,236,164,400,0,0,163,0,1,164,0,18.10,18.40,True,86,77,sebsi:  marzouki:  
9,6,4,71,1,305,231,400,1,168,231,400,0,0,228,1,2,231,0,18.15,19.00,True,131,97,sebsi:1  marzouki:1  
9,6,3,70,5,501,218,596,0,378,218,596,0,0,215,1,2,218,0,08.00,,True,108,107,sebsi:1  marzouki:1  
9,6,3,70,4,501,244,610,0,366,244,610,0,0,242,1,1,244,0,18.20,19.00,True,125,117,sebsi:1  marzouki:1  
9,6,3,70,3,501,319,599,1,280,318,599,0,1,311,4,3,318,0,,19.05,True,166,145,sebsi:  marzouki:  
9,6,3,70,2,501,352,596,0,244,352,596,0,0,344,6,2,352,0,18.18,19.05,True,228,116,sebsi:1  marzouki:1  
9,6,3,70,1,501,356,598,0,242,356,598,0,0,346,3,7,356,0,18.25,19.05,True,230,116,sebsi:1  marzouki:1  :  
9,6,2,69,4,582,307,700,0,393,307,700,0,0,299,4,4,307,0,18.30,19.15,True,124,175,sebsi:1  marzouki:1  :  
9,6,2,69,3,582,373,700,0,327,373,700,0,0,363,6,4,373,0,18.30,19.30,True,153,210,sebsi:1  marzouki:1  
9,6,2,69,2,582,417,700,1,282,417,700,0,0,413,3,1,417,0,18.20,19.30,True,194,219,sebsi:1  marzouki:1  
9,6,2,69,1,582,428,700,2,270,428,700,0,0,415,9,4,428,0,18.20,19.30,True,236,179,sebsi:1  marzouki:1  
9,6,2,68,4,465,196,500,0,304,196,500,0,0,192,1,3,196,0,18.15,19.00,True,93,99,sebsi:1  marzouki:1  
9,6,2,68,3,465,264,500,1,235,264,500,0,0,260,2,2,264,0,18.21,19.00,True,116,144,sebsi:1  marzouki:1  
9,6,2,68,2,465,307,502,0,195,307,502,0,0,300,2,5,307,0,18.15,19.04,False,153,147,sebsi:1  marzouki:1  
9,6,2,68,1,465,313,498,0,185,313,498,0,0,299,3,11,313,0,,19.10,True,188,111,sebsi:1  marzouki:1  
9,6,1,67,8,546,288,600,0,312,288,600,0,0,282,4,2,288,0,18.30,19.20,True,146,136,sebsi:1  marzouki:1  
9,6,1,67,7,552,281,600,0,319,281,600,0,0,273,4,4,281,0,18.30,19.40,False,122,151,sebsi:1  marzouki:1  
9,6,1,67,6,552,312,596,0,284,312,596,0,0,303,4,5,312,0,18.15,20.23,False,153,150,sebsi:  marzouki:  
9,6,1,67,5,552,353,600,0,247,353,600,0,0,342,9,2,353,0,18.22,19.27,True,181,161,sebsi:1  marzouki:1  
9,6,1,67,4,552,387,600,0,213,387,600,0,0,374,5,8,387,0,,19.55,True,216,158,sebsi:1  marzouki:1  
9,6,1,67,3,552,402,600,0,198,402,600,0,0,389,9,4,402,0,18.30,19.15,True,234,155,sebsi:1  marzouki:1  
9,6,1,67,2,552,393,602,0,209,393,602,0,0,376,5,12,393,0,18.43,,True,261,115,sebsi:1  marzouki:1  
9,6,1,67,1,552,419,600,4,177,419,600,0,0,409,8,2,419,0,18.30,19.30,False,280,129,sebsi:1  marzouki:1  
9,11,7,164,2,382,150,500,0,350,150,500,0,0,140,7,3,150,0,18.12,18.50,False,75,65,sebsi:1  marzouki:1  
9,11,7,164,1,383,232,500,0,268,232,500,0,0,214,13,5,232,0,18.13,19.05,True,165,49,sebsi:1  marzouki:1  
9,11,6,163,1,126,44,200,0,156,44,200,0,0,42,1,1,44,0,18.05,18.30,True,19,23,sebsi:1  marzouki:1  
9,11,5,162,1,315,126,400,0,274,126,400,0,0,125,1,0,126,0,18.15,18.40,True,93,32,sebsi:1  marzouki:1  
9,11,4,161,3,499,187,600,0,413,187,600,0,0,180,5,2,187,0,18.14,19.00,True,129,51,sebsi:1  marzouki:1  
9,11,4,161,2,500,294,600,0,306,294,600,0,0,270,24,0,294,0,18.20,19.15,True,229,41,sebsi:1  marzouki:1  
9,11,4,161,1,500,292,600,2,302,292,596,0,0,277,13,2,292,0,1814,1906,True,234,43,sebsi:1  marzouki:1  
9,11,4,160,2,312,96,400,0,304,96,400,0,0,95,1,0,96,0,18.05,18.40,True,70,25,sebsi:1  marzouki:1  
9,11,4,160,1,313,121,400,0,279,121,400,0,0,96,23,2,121,0,18.00,18.30,True,82,14,sebsi:1  marzouki:1  
9,11,3,159,1,326,115,400,0,285,115,400,0,0,106,7,2,115,0,18.20,18.50,True,56,50,sebsi:1  marzouki:1  
9,11,3,158,1,432,233,502,0,269,233,502,0,0,221,9,3,233,0,18.15,18.45,False,140,81,sebsi:1  marzouki:1  
9,11,3,157,1,138,80,200,0,120,80,200,0,0,68,11,1,80,0,18.15,19.00,True,48,20,sebsi:1  marzouki:1  
9,11,3,156,1,244,123,300,0,177,123,300,0,0,122,1,0,123,0,18.30,19.00,True,109,13,sebsi:1  marzouki:1  
9,11,2,154,1,207,98,300,2,200,98,300,0,0,94,2,2,98,0,18.20,19.00,False,63,31,sebsi:1  marzouki:1  
9,11,1,153,1,183,77,200,0,123,77,200,0,0,73,4,0,77,0,18.30,18.55,True,59,14,sebsi:1  marzouki:1  
9,11,1,152,1,204,106,299,2,191,106,299,0,0,99,5,2,106,0,1810,1845,False,71,28,sebsi:1  marzouki:1  
9,11,1,151,1,291,133,400,1,266,133,400,0,0,131,1,1,133,0,18.15,19.10,True,105,26,sebsi:1  marzouki:1  
9,11,1,150,4,581,223,700,0,477,223,700,0,0,216,5,2,223,0,18.05,19.00,True,162,54,sebsi:1  marzouki:1  
9,11,1,150,3,582,298,700,0,402,298,700,0,0,284,9,5,298,0,18.15,19.09,True,215,69,sebsi:1  marzouki:1  
9,11,1,150,2,582,347,700,0,353,347,700,0,0,331,14,2,347,0,18.20,19.28,True,277,54,sebsi:1  marzouki:1  
9,11,1,150,1,582,373,700,0,327,373,700,0,0,361,10,2,373,0,18.05,19.05,True,319,42,sebsi:1  marzouki:1  
9,10,4,148,3,448,235,500,6,259,235,500,0,0,231,4,0,235,0,,19:30,False,89,142,sebsi:  marzouki:  :  
9,10,4,148,2,448,286,501,1,215,285,501,0,1,280,4,1,285,0,18.30,19.08,True,119,161,sebsi:1  marzouki:1  
9,10,4,148,1,448,295,500,2,203,295,500,0,0,290,5,0,295,0,18.30,19.30,True,159,131,sebsi:1  marzouki:1  
9,10,3,147,3,448,243,500,0,257,243,500,0,0,237,5,1,243,0,18.30,19.40,True,104,133,sebsi:1  marzouki:1  
9,10,3,147,2,449,281,500,1,218,281,500,0,0,274,6,1,281,0,18.30,19.30,True,149,125,sebsi:1  marzouki:1  
9,10,3,147,1,449,326,499,1,172,326,499,0,0,323,2,1,326,0,18.40,20.05,True,209,114,sebsi:1  marzouki:1  
9,10,2,145,2,461,236,500,0,264,236,500,0,0,232,2,2,236,0,18.30,19.30,False,138,94,sebsi:1  marzouki:0  
9,10,2,145,1,461,279,501,0,222,279,501,0,0,273,4,2,279,0,18.31,19.20,False,189,84,sebsi:1  marzouki:0  
9,10,1,144,2,583,342,701,0,359,342,701,0,0,334,5,3,342,0,18.40,19.55,True,164,170,sebsi:1  marzouki:0  
9,10,1,144,1,584,438,700,1,261,438,700,0,0,430,3,5,438,0,18.42,19.55,False,261,169,sebsi:1  marzouki:0  
9,10,1,143,3,508,335,600,1,264,335,600,0,0,333,1,1,335,0,18.35,19.20,True,143,190,sebsi:1  marzouki:0  
9,10,1,143,2,510,382,600,0,218,382,600,0,0,380,1,1,382,0,18.30,19.35,True,182,198,sebsi:1  marzouki:0  
9,10,1,143,1,510,400,600,2,198,400,600,0,0,392,5,3,400,0,18.43,20.12,True,219,173,sebsi:1  marzouki:0  
9,1,4,10,1,131,69,200,0,131,69,200,0,0,64,3,2,69,0,18.00,18.30,True,46,18,sebsi:1  marzouki:1  
9,1,4,9,3,477,174,592,0,418,174,592,0,0,170,2,2,174,0,18.30,19.00,True,62,108,sebsi:1  marzouki:1  
9,1,4,9,2,479,247,596,0,349,247,596,0,0,242,4,1,247,0,18.30,19.15,True,117,125,sebsi:1  marzouki:1  
9,1,4,9,1,479,302,600,0,298,302,600,0,0,282,5,15,302,0,,19.25,True,175,107,sebsi:1  marzouki:1  
9,1,4,8,2,318,154,399,0,245,154,399,0,0,152,2,0,154,0,06.30,18.50,True,49,103,sebsi:1  marzouki:1  
9,1,4,8,1,319,197,400,0,203,197,400,0,0,188,5,4,197,0,18.30,18.50,True,96,92,sebsi:1  marzouki:1  
9,1,3,7,3,405,201,500,2,297,201,500,0,0,197,3,1,201,0,18.50,19.55,True,55,142,sebsi:1  marzouki:1  
9,1,3,7,2,406,255,500,1,244,255,500,0,0,246,4,5,255,0,18.50,19.45,True,81,165,sebsi:1  marzouki:1  
9,1,3,7,1,406,265,499,0,234,265,499,0,0,254,7,4,265,0,,20.00,True,125,129,sebsi:1  marzouki:1  
9,1,3,6,1,462,237,500,0,263,237,500,0,0,235,2,0,237,0,18.20,19.40,False,129,106,sebsi:  marzouki:  
9,1,3,5,1,88,47,100,0,53,47,100,0,0,45,0,2,47,0,18.15,18.56,False,33,12,sebsi:1  :  
9,1,2,4,3,416,223,502,0,279,223,502,0,0,210,5,8,223,0,18.30,18.56,True,80,130,sebsi:1  marzouki:1  
9,1,2,4,2,417,267,500,2,231,267,500,0,0,265,1,1,267,0,18.45,19.35,True,90,175,sebsi:1  marzouki:1  
9,1,2,4,1,417,286,500,0,215,285,500,0,1,279,3,3,285,0,18.45,19.50,True,154,125,sebsi:1  marzouki:1  
9,1,2,3,5,594,334,700,0,366,334,700,0,0,325,7,2,334,0,18.30,19.05,True,84,241,sebsi:  marzouki:  
9,1,2,3,4,595,330,700,0,370,330,700,0,0,327,1,2,330,0,18.20,19.00,True,85,242,sebsi:  marzouki:  
9,1,2,3,3,595,413,700,1,286,413,700,0,0,410,1,2,413,0,18.15,19.45,True,126,284,sebsi:1  marzouki:1  
9,1,2,3,2,595,453,700,13,235,452,700,0,1,436,11,5,452,0,18.35,20.15,True,168,268,sebsi:1  marzouki:1  
9,1,2,3,1,595,426,692,0,266,426,692,0,0,405,12,9,426,0,18.30,19.45,True,180,225,sebsi:1  marzouki:1  
9,1,2,2,4,552,277,600,0,323,277,600,0,0,264,8,5,277,0,18.45,19.40,True,80,184,sebsi:1  marzouki:1  
9,1,2,2,3,555,291,600,0,309,291,600,0,0,284,5,2,291,0,18.15,19.35,True,83,201,sebsi:1  marzouki:1  
9,1,2,2,2,555,357,599,1,242,356,599,0,1,342,9,5,356,0,18.45,20.13,True,134,208,sebsi:1  marzouki:1  
9,1,2,2,1,555,355,599,0,244,355,599,0,0,337,14,4,355,0,18.30,19.35,True,180,157,sebsi:1  marzouki:1  
9,1,1,1,2,347,219,400,0,181,219,400,0,0,209,3,7,219,0,18.10,19.30,True,134,75,sebsi:1  marzouki:1  
9,1,1,1,1,348,245,401,0,156,245,401,0,0,237,7,1,245,0,18.20,19.10,True,181,56,sebsi:1  marzouki:1  
9,3,9,42,1,176,63,200,0,137,63,200,0,0,62,1,0,63,0,18.10,18.35,False,44,18,sebsi:1  marzouki:0  
9,3,9,41,1,108,60,200,0,140,60,200,0,0,60,0,0,60,0,18.30,19.15,True,46,14,sebsi:1  marzouki:0  
9,3,9,40,1,302,149,400,0,251,149,400,0,0,146,2,1,149,0,18.20,18.33,True,81,65,sebsi:1  marzouki:1  
9,3,8,39,5,540,231,600,0,369,231,600,0,0,222,3,6,231,0,18.15,19.00,True,115,107,sebsi:1  marzouki:0  
9,3,8,39,4,542,246,600,0,354,246,600,0,0,237,8,1,246,0,18.35,19.30,True,127,110,sebsi:1  marzouki:0  
9,3,8,39,3,542,322,590,1,267,322,590,0,0,315,2,5,322,0,18.20,19.30,True,193,122,sebsi:1  marzouki:1  
9,3,8,39,2,542,366,601,0,235,366,601,0,0,359,2,5,366,0,18.50,20.00,True,226,133,sebsi:1  marzouki:1  
9,3,8,39,1,542,348,599,1,250,348,599,0,0,327,13,8,348,0,18.30,20.20,True,256,71,sebsi:1  marzouki:0  
9,3,7,38,3,534,222,600,0,378,222,600,0,0,212,5,5,222,0,1817,1900,False,112,100,sebsi:1  marzouki:1  
9,3,7,38,2,534,292,603,0,311,292,603,0,0,286,6,0,292,0,06.00,18.56,False,177,109,sebsi:1  marzouki:1  
9,3,7,38,1,534,325,600,0,275,325,600,0,0,307,16,2,325,0,18.15,19.10,False,228,79,sebsi:1  marzouki:0  
9,3,6,37,1,443,209,500,0,291,209,500,0,0,202,6,1,209,0,18.20,19.10,False,143,59,sebsi:1  marzouki:1  
9,3,6,36,3,528,280,602,0,322,280,602,0,0,275,3,2,280,0,18.38,19.20,False,184,91,sebsi:1  marzouki:0  
9,3,6,36,2,600,349,600,0,251,349,600,0,0,343,2,4,349,0,18.20,19.10,False,221,122,sebsi:1  marzouki:1  
9,3,6,36,1,530,395,600,0,205,395,600,0,0,377,18,0,395,0,1830,1921,True,297,80,sebsi:1  marzouki:1  
9,3,6,35,3,452,192,501,1,308,192,501,0,0,189,1,2,192,0,18.15,19.15,True,115,74,sebsi:1  marzouki:0  
9,3,6,35,2,454,291,500,0,209,291,500,0,0,279,7,5,291,0,18.25,19.20,True,185,94,sebsi:1  marzouki:0  
9,3,6,35,1,454,310,498,0,188,310,498,0,0,292,10,8,310,0,18.30,19.22,True,207,85,sebsi:1  marzouki:1  
9,3,5,34,2,397,195,500,0,305,195,500,0,0,192,1,2,195,0,18.00,19.00,True,77,115,sebsi:1  marzouki:1  
9,3,5,34,1,398,278,500,0,222,278,500,0,0,269,6,3,278,0,18.00,18.57,True,153,116,sebsi:1  marzouki:1  
9,3,5,32,3,513,224,594,1,369,224,594,0,0,214,9,1,224,0,18.10,18.58,True,86,128,sebsi:1  marzouki:1  
9,3,5,32,2,513,330,600,4,266,330,600,0,0,314,14,2,330,0,18.24,19.15,True,146,168,sebsi:1  marzouki:1  
9,3,5,32,1,513,343,600,0,257,343,600,0,0,319,21,3,343,0,18.20,19.19,True,210,109,sebsi:1  marzouki:1  
9,3,4,31,1,162,63,200,0,137,63,200,0,0,58,5,0,63,0,19.00,19.30,True,48,10,sebsi:1  marzouki:1  
9,3,3,30,4,466,168,500,2,330,168,500,0,0,162,3,3,168,0,18.20,18.50,False,74,88,sebsi:1  marzouki:1  
9,3,3,30,3,468,205,500,0,295,205,500,0,0,199,5,1,205,0,18.30,19.05,True,89,110,sebsi:1  marzouki:1  
9,3,3,30,2,468,282,500,0,220,280,500,0,2,274,3,3,280,0,18.35,19.21,True,149,125,sebsi:1  marzouki:1  
9,3,3,30,1,468,293,502,0,209,293,502,0,0,282,8,3,293,0,18.15,19.30,False,191,91,sebsi:1  marzouki:1  
9,3,3,29,1,305,135,400,0,265,135,400,0,0,132,3,0,135,0,18.15,18.50,True,64,68,sebsi:1  marzouki:1  
9,3,3,28,1,596,292,700,2,406,292,700,0,0,283,7,2,292,0,18.30,19.30,True,158,125,sebsi:1  marzouki:1  
9,3,3,27,1,435,181,500,0,319,181,500,0,0,169,8,4,181,0,18.15,18.45,True,125,44,sebsi:1  :1  
9,3,3,26,1,453,179,500,0,321,179,500,0,0,177,2,0,179,0,,18.50,True,100,77,sebsi:1  
9,3,3,25,1,453,232,500,0,268,232,500,0,0,228,2,2,232,0,18.20,19.00,True,153,75,sebsi:1  marzouki:1  
9,3,3,24,1,526,258,600,0,342,258,600,0,0,254,3,1,258,0,18.15,19.10,True,150,104,sebsi:  marzouki:  
9,3,2,23,2,552,257,600,0,343,257,600,0,0,245,9,3,257,0,18.20,19.00,True,137,108,sebsi:  marzouki:  
9,3,2,23,1,552,357,600,0,243,357,600,0,0,344,9,4,357,0,18.15,19.15,True,189,155,sebsi:1  marzouki:1  
9,3,1,22,1,164,39,200,0,161,39,200,0,0,36,1,2,39,0,18.00,18.21,False,24,12,sebsi:1  marzouki:1  
9,4,9,60,2,458,250,500,0,250,250,500,0,0,245,3,2,250,0,18.20,19.00,True,116,129,sebsi:1  marzouki:1  
9,4,9,60,1,459,329,500,1,170,329,500,0,0,322,4,3,329,0,18.15,19.19,True,182,140,sebsi:1  marzouki:1  
9,4,9,59,4,474,290,500,0,210,290,500,0,0,285,2,3,290,0,18.40,19.25,False,121,164,sebsi:1  marzouki:1  
9,4,9,59,3,476,333,500,1,166,333,500,0,0,327,4,2,333,0,18.42,19.40,False,137,190,sebsi:1  marzouki:1  
9,4,9,59,2,476,359,500,1,140,359,500,0,0,357,2,0,359,0,18.45,19.45,False,169,188,sebsi:1  marzouki:1  
9,4,9,59,1,476,357,501,0,144,357,501,0,0,351,4,2,357,0,18.45,20.25,False,220,131,sebsi:1  marzouki:1  
9,4,9,58,1,232,100,300,0,200,100,300,0,0,98,1,1,100,0,18.30,19.00,False,51,47,sebsi:1  marzouki:1  
9,4,9,57,2,460,167,501,0,334,167,501,0,0,163,0,4,167,0,18.19,18.46,False,100,63,sebsi:1  marzouki:1  
9,4,9,57,1,460,225,500,0,275,225,500,0,0,218,4,3,225,0,18.20,19.15,False,151,67,sebsi:1  marzouki:1  
9,4,9,56,6,582,280,700,2,418,280,700,0,0,267,8,5,280,0,18.25,19.10,False,117,150,sebsi:1  marzouki:1  
9,4,9,56,5,582,272,700,0,428,272,700,0,0,266,2,4,272,0,18.30,19.30,True,142,124,sebsi:1  marzouki:1  
9,4,9,56,4,582,328,700,0,372,328,700,0,0,324,2,2,328,0,18.15,19.15,True,148,176,sebsi:  marzouki:  
9,4,9,56,3,582,394,700,0,306,394,700,0,0,388,5,1,394,0,18.35,19.17,False,209,179,sebsi:  marzouki:  
9,4,9,56,2,582,398,705,3,304,398,705,0,0,388,9,1,398,0,18.30,19.25,False,221,167,sebsi:  marzouki:  
9,4,9,56,1,582,404,700,0,296,404,700,0,0,391,2,11,404,0,18.30,19.15,True,260,131,sebsi:  marzouki:  
9,4,8,55,7,532,341,600,0,259,341,600,0,0,324,11,6,341,0,18.30,19.45,True,150,174,sebsi:1  marzouki:1  
9,4,8,55,6,532,318,600,0,282,318,600,0,0,305,10,3,318,0,18.15,19.25,True,132,173,sebsi:1  marzouki:1  
9,4,8,55,5,532,353,600,1,246,353,600,0,0,349,2,2,353,0,18.30,19.15,True,159,190,sebsi:1  marzouki:1  
9,4,8,55,4,532,408,598,1,189,408,598,0,0,403,2,3,408,0,,19.20,True,186,217,sebsi:1  marzouki:1  
9,4,8,55,3,532,398,600,1,201,398,600,0,0,391,4,3,398,0,18.27,19.25,False,175,216,sebsi:1  marzouki:1  
9,4,8,55,2,532,373,600,0,230,370,600,0,3,356,8,6,370,0,18.30,19.40,True,191,165,sebsi:1  marzouki:1  
9,4,8,55,1,532,412,600,3,186,412,601,1,0,398,8,6,412,0,18.30,20.45,True,244,154,sebsi:1  marzouki:1  
9,4,7,54,3,476,301,600,0,299,301,600,0,0,285,9,7,301,0,18.35,19.30,False,179,106,sebsi:1  marzouki:0  
9,4,7,54,2,477,331,599,0,268,331,599,0,0,326,1,4,331,0,,19.20,True,201,125,sebsi:1  marzouki:0  
9,4,7,54,1,477,369,600,2,229,369,600,0,0,363,1,5,369,0,18.25,19.25,False,251,112,sebsi:1  marzouki:0  
9,4,7,53,5,524,260,600,0,340,260,600,0,0,250,5,5,260,0,18.35,19.30,True,120,130,sebsi:1  marzouki:1  
9,4,7,53,4,526,281,600,0,319,281,600,0,0,276,2,3,281,0,18.26,19.28,True,133,143,sebsi:1  marzouki:1  
9,4,7,53,3,526,324,600,0,276,324,600,0,0,317,5,2,324,0,18.35,19.45,True,164,153,sebsi:1  marzouki:1  
9,4,7,53,2,526,352,600,0,248,352,600,0,0,342,6,4,352,0,18.30,19.10,True,207,135,sebsi:1  marzouki:1  
9,4,7,53,1,526,351,600,1,248,351,600,0,0,339,10,2,351,0,18.30,19.35,True,219,120,sebsi:1  marzouki:1  
9,4,7,52,8,527,342,601,3,256,342,601,0,0,327,7,8,342,0,18.25,19.40,True,145,182,sebsi:1  marzouki:1  
9,4,7,52,7,528,304,611,0,307,304,611,0,0,295,5,4,304,0,18.15,18.45,True,130,165,sebsi:1  marzouki:1  
9,4,7,52,6,528,352,598,0,246,352,598,0,0,347,4,1,352,0,18.45,19.20,True,143,204,sebsi:1  marzouki:1  
9,4,7,52,5,528,379,600,0,221,379,600,0,0,360,9,10,379,0,18.35,19.47,True,168,192,sebsi:1  marzouki:1  
9,4,7,52,4,528,411,600,0,189,411,600,0,0,404,5,2,411,0,18.30,19.45,True,172,232,sebsi:1  marzouki:1  
9,4,7,52,3,528,397,600,4,200,396,600,0,0,376,14,6,396,0,18.40,19.55,True,196,180,sebsi:1  marzouki:1  
9,4,7,52,2,528,402,600,0,198,402,600,0,0,385,6,11,402,0,18.45,19.40,True,203,182,sebsi:1  marzouki:1  
9,4,7,52,1,528,371,601,2,227,371,600,0,0,356,12,3,371,0,18.35,19.48,True,193,163,sebsi:1  marzouki:1  
9,4,6,51,8,571,352,700,0,348,352,700,0,0,340,7,5,352,0,19.05,20.10,False,165,175,sebsi:1  marzouki:1  
9,4,6,51,7,574,326,700,0,374,326,700,0,0,314,6,6,326,0,18.45,20.05,True,157,157,sebsi:1  marzouki:1  
9,4,6,51,6,574,348,699,0,351,348,699,0,0,340,4,4,348,0,18.55,20.00,False,165,175,sebsi:1  marzouki:1  
9,4,6,51,5,574,433,700,0,268,432,700,0,1,420,8,4,432,0,18.40,20.00,False,219,201,sebsi:1  marzouki:1  
9,4,6,51,4,574,420,700,0,280,420,700,0,0,411,6,3,420,0,18.40,19.40,False,216,195,sebsi:1  marzouki:1  
9,4,6,51,3,574,451,700,0,249,451,700,0,0,444,4,3,451,0,19.15,20.40,True,253,191,sebsi:1  marzouki:1  
9,4,6,51,2,574,429,700,2,269,429,700,0,0,415,9,5,429,0,18.50,21.10,True,262,153,sebsi:1  marzouki:1  
9,4,6,51,1,574,454,699,0,245,454,699,0,0,447,3,4,454,0,18.30,19.30,False,288,159,sebsi:1  marzouki:1  
9,4,5,50,3,467,257,501,1,243,257,501,0,0,251,3,3,257,0,18.35,19.35,True,129,122,sebsi:1  marzouki:1  
9,4,5,50,2,468,291,501,0,210,291,501,0,0,286,4,1,291,0,18.30,19.30,False,147,139,sebsi:1  marzouki:1  
9,4,5,50,1,468,331,500,0,169,331,500,0,0,323,6,2,331,0,18.15,19.15,False,209,114,sebsi:1  marzouki:1  
9,4,5,49,8,555,372,600,0,228,372,600,0,0,362,3,7,372,0,18.25,19.10,True,155,207,sebsi:1  marzouki:1  
9,4,5,49,7,562,326,600,1,273,326,600,0,0,317,7,2,326,0,18.24,19.20,False,137,180,sebsi:1  marzouki:1  
9,4,5,49,6,562,361,600,0,239,361,600,0,0,346,9,6,361,0,18.13,19.24,False,152,194,sebsi:1  marzouki:1  
9,4,5,49,5,562,407,600,1,192,407,600,0,0,400,2,5,407,0,18.45,19.50,True,187,213,sebsi:1  marzouki:1  
9,4,5,49,4,562,439,597,0,158,439,597,0,0,426,8,5,439,0,18.25,19.20,False,238,188,sebsi:1  marzouki:1  
9,4,5,49,3,562,449,598,0,149,449,598,0,0,443,3,3,449,0,19.00,19.50,True,220,223,sebsi:1  marzouki:1  
9,4,5,49,2,562,420,600,2,178,420,600,0,0,405,7,8,420,0,18.15,19.45,False,225,180,sebsi:1  marzouki:1  
9,4,5,49,1,562,454,600,3,143,454,600,0,0,446,1,7,454,0,18.40,19.45,True,259,187,sebsi:1  marzouki:1  
9,4,4,48,4,467,241,500,0,259,241,500,0,0,235,3,3,241,0,18.40,19.25,False,96,139,sebsi:1  marzouki:1  
9,4,4,48,3,468,255,500,0,245,255,500,0,0,249,4,2,255,0,18.40,19.35,True,109,140,sebsi:1  marzouki:1  
9,4,4,48,2,468,302,500,2,196,302,500,0,0,295,1,6,302,0,18.15,19.00,True,144,151,sebsi:1  marzouki:1  
9,4,4,48,1,468,308,500,1,191,308,500,0,0,298,9,1,308,0,18.30,19.40,True,170,128,sebsi:  marzouki:  
9,4,4,47,8,520,320,598,0,278,320,598,0,0,306,7,7,320,0,18.45,20.00,True,168,138,sebsi:  marzouki:  
9,4,4,47,6,527,321,609,1,287,321,609,0,0,312,3,6,321,0,18.45,19.55,False,147,165,sebsi:1  marzouki:1  
9,4,4,47,5,527,375,600,0,225,375,600,0,0,371,4,0,375,0,19.00,20.10,True,173,198,sebsi:1  marzouki:1  
9,4,4,47,4,527,389,600,0,211,389,600,0,0,385,2,2,389,0,18.55,19.55,False,231,154,sebsi:1  marzouki:1  
9,4,4,47,3,527,380,600,0,220,380,600,0,0,370,4,6,380,0,18.45,19.42,False,203,167,sebsi:1  marzouki:1  
9,4,4,47,2,527,388,599,0,211,388,599,0,0,374,7,7,388,0,18.45,19.42,False,250,124,sebsi:  marzouki:  
9,4,4,47,1,527,411,600,0,183,411,594,0,0,403,4,4,411,0,18.50,19.50,False,292,111,sebsi:1  marzouki:1  
9,4,3,46,5,522,309,600,0,291,309,600,0,0,296,3,10,309,0,18.45,20.00,True,177,119,sebsi:  marzouki:  
9,4,3,46,4,526,352,600,0,248,352,600,0,0,338,3,11,352,0,18.47,19.44,False,194,144,sebsi:  marzouki:  
9,4,3,46,3,526,400,600,0,200,400,600,0,0,394,3,3,400,0,19.00,19.55,True,242,152,sebsi:  marzouki:  
9,4,3,46,2,526,421,600,2,177,421,600,0,0,418,2,1,421,0,18.53,20.16,True,274,144,sebsi:  marzouki:  
9,4,3,46,1,526,423,600,1,176,423,600,0,0,411,6,6,423,0,18.49,19.58,True,298,113,sebsi:  marzouki:  
9,4,2,45,5,506,300,600,0,300,300,600,0,0,287,5,8,300,0,18.25,19.30,False,146,141,sebsi:  marzouki:  
9,4,2,45,4,508,291,600,0,309,291,600,0,0,282,1,8,291,0,18.30,19.05,True,149,133,sebsi:  marzouki:  
9,4,2,45,3,508,381,600,0,219,381,600,0,0,374,5,2,381,0,18.30,19.35,True,202,172,sebsi:  marzouki:  
9,4,2,45,2,508,364,600,1,236,363,600,0,1,357,3,3,363,0,18.35,19.24,False,182,175,sebsi:1  marzouki:1  
9,4,2,45,1,508,391,599,0,208,391,599,0,0,387,3,1,391,0,18.20,19.25,True,241,146,sebsi:1  marzouki:1  
9,4,1,44,7,571,348,700,0,352,348,700,0,0,340,6,2,348,0,18.36,,True,166,174,sebsi:1  marzouki:1  
9,4,1,44,6,577,303,696,0,393,303,696,0,0,299,2,2,303,0,,19.30,True,162,137,sebsi:1  marzouki:1  
9,4,1,44,5,577,364,701,0,337,364,701,0,0,360,2,2,364,0,18.45,20.00,True,157,203,sebsi:1  marzouki:1  
9,4,1,44,4,577,400,701,0,301,400,701,0,0,393,6,1,400,0,18.40,19.30,True,189,204,sebsi:1  marzouki:1  
9,4,1,44,3,577,412,700,0,288,412,700,0,0,401,6,5,412,0,19.00,20.00,False,201,200,sebsi:1  marzouki:1  
9,4,1,44,2,577,394,700,0,306,394,700,0,0,384,8,2,394,0,18.45,20.15,True,234,150,sebsi:1  marzouki:1  
9,4,1,44,1,577,412,700,0,288,412,700,0,0,399,3,10,412,0,,20.00,True,252,147,sebsi:1  marzouki:1  
