circonscriptionId,delegationId,subDelegationId,centerID,stationId,registeredVoters,aSigningVoters,bDeliveredBallots,cSpoiledBallots,dLeftBallots,fExtractedBallots,gEplusF,hBminusG,iAminusF,jListVotes,kCancelledVotes,lBlankVotes,mJplusKplusL,nFminusM,countingStart,countingEnd,tampon,sebsi,marzouki,observers
1,11,8,104,1,493,298,600,0,302,298,600,0,0,289,7,2,298,0,1815,1900,True,209,80,sebsi:1  marzouki:1  
1,11,7,103,1,248,138,300,0,162,138,300,0,0,138,0,0,138,0,1815,130,True,88,50,sebsi:1  marzouki:0  
1,11,7,102,2,502,301,600,1,298,301,600,0,0,291,8,2,301,0,0,1902,True,133,158,sebsi:1  marzouki:1  
1,11,7,102,1,502,348,600,1,251,348,600,0,0,335,11,2,348,0,1815,1900,True,203,132,sebsi:1  marzouki:1  
1,11,7,101,2,570,278,600,0,322,278,600,0,0,272,3,3,278,0,1800,1845,True,141,131,sebsi:1  marzouki:0  
1,11,7,101,1,570,362,600,0,238,362,600,0,0,356,4,2,362,0,1815,1913,True,216,140,sebsi:1  marzouki:1  
1,11,7,100,1,534,290,600,0,310,290,600,0,0,283,2,5,290,0,1810,1900,True,154,129,sebsi:1  marzouki:0  
1,11,6,99,4,530,256,600,0,344,256,600,0,0,251,1,4,256,0,1835,1935,True,128,123,sebsi:1  marzouki:1  
1,11,6,99,3,531,273,600,0,327,273,600,0,0,266,3,4,273,0,1830,1900,True,137,129,sebsi:1  marzouki:1  
1,11,6,99,1,531,376,600,0,224,376,600,0,0,363,5,8,376,0,1830,1935,True,235,128,sebsi:1  marzouki:1  
1,11,5,98,7,520,305,600,0,295,305,600,0,0,298,4,3,305,0,1815,1900,True,126,172,sebsi:1  marzouki:1  
1,11,5,98,6,523,295,600,0,305,295,600,0,0,288,7,0,295,0,1820,1910,True,126,162,sebsi:1  marzouki:1  
1,11,5,98,5,523,305,600,0,295,305,600,0,0,302,1,2,305,0,1820,1900,True,111,191,sebsi:1  marzouki:1  
1,11,5,98,4,523,332,600,0,268,332,600,0,0,323,7,2,332,0,1815,1925,True,138,185,sebsi:1  marzouki:1  
1,11,5,98,3,523,346,600,0,254,346,600,0,0,335,6,5,346,0,1815,1910,True,172,163,sebsi:1  marzouki:1  
1,11,5,98,2,523,359,600,0,241,359,600,0,0,353,6,0,359,0,1815,1900,False,206,147,sebsi:1  marzouki:1  
1,11,5,98,1,523,378,600,0,222,378,600,0,0,363,13,2,378,0,1806,1910,True,223,140,sebsi:1  marzouki:1  
1,11,5,97,2,589,301,700,0,399,301,700,0,0,297,3,1,301,0,1831,1920,True,115,182,sebsi:1  marzouki:1  
1,11,5,97,1,590,393,700,0,307,393,700,0,0,381,6,6,393,0,1825,1930,True,201,180,sebsi:1  marzouki:1  
1,11,4,96,4,555,243,600,0,357,243,600,0,0,237,3,3,243,0,1825,1906,True,121,116,sebsi:1  marzouki:0  
1,11,4,96,3,557,271,600,1,328,271,600,0,0,266,4,1,271,0,1830,1932,True,125,141,sebsi:1  marzouki:0  
1,11,4,96,2,557,349,600,0,251,349,600,0,0,336,5,8,349,0,1818,1912,True,178,158,sebsi:1  marzouki:0  
1,11,4,96,1,557,375,600,0,225,375,600,0,0,365,7,3,375,0,1805,1905,True,216,149,sebsi:1  marzouki:0  
1,11,4,95,1,362,154,400,0,246,154,400,0,0,151,3,0,154,0,1810,1900,True,94,57,sebsi:1  marzouki:0  
1,11,3,94,2,552,279,600,0,321,279,600,0,0,274,2,3,279,0,1830,1915,True,139,135,sebsi:1  marzouki:1  
1,11,3,94,1,553,379,595,0,216,379,595,0,0,369,10,0,379,0,1810,1930,True,220,149,sebsi:1  marzouki:1  
1,11,3,93,3,528,290,600,0,310,290,600,0,0,283,6,1,290,0,1815,1910,False,137,146,sebsi:1  
1,11,3,93,2,528,315,600,0,285,315,600,0,0,304,4,7,315,0,1825,1915,True,169,135,sebsi:1  marzouki:1  
1,11,3,93,1,528,358,600,0,242,358,600,0,0,349,6,3,358,0,1815,1915,True,218,131,sebsi:1  
1,11,3,92,7,513,276,600,1,323,276,600,0,0,273,2,1,276,0,1815,1835,True,126,147,sebsi:1  
1,11,3,92,6,519,212,600,0,388,212,600,0,0,206,3,3,212,0,1805,1835,True,104,102,sebsi:1  
1,11,3,92,5,519,248,600,0,352,248,600,0,0,242,5,1,248,0,1800,,True,117,125,sebsi:1  
1,11,3,92,4,519,275,590,0,315,275,590,0,0,270,5,0,275,0,1815,1900,True,133,137,sebsi:1  
1,11,3,92,3,519,335,600,1,264,335,600,0,0,327,7,1,335,0,1800,1845,True,180,147,sebsi:1  
1,11,3,92,2,519,322,600,0,278,322,600,0,0,317,2,3,322,0,1807,1840,True,178,139,sebsi:1  
1,11,3,92,1,519,371,600,1,228,371,600,0,0,362,5,4,371,0,1815,1910,True,225,137,sebsi:1  marzouki:1  
1,11,3,91,5,526,284,600,0,316,284,600,0,0,276,2,6,284,0,,1855,True,134,142,sebsi:1  
1,11,3,91,4,526,256,596,0,340,256,596,0,0,250,2,4,256,0,1825,1918,True,122,128,sebsi:1  
1,11,3,91,3,526,308,600,0,292,308,600,0,0,299,0,9,308,0,,1921,True,145,154,sebsi:1  
1,11,3,91,2,526,335,600,1,264,335,600,0,0,328,3,4,335,0,1823,1910,True,178,150,sebsi:1  marzouki:1  
1,11,3,91,1,526,337,600,1,262,337,600,0,0,332,0,5,337,0,1820,1905,True,219,113,sebsi:1  marzouki:1  
1,11,2,90,7,582,285,700,0,415,285,700,0,0,276,5,4,285,0,,1855,True,133,143,sebsi:1  
1,11,2,90,6,586,248,696,0,448,248,696,0,0,235,3,10,248,0,1815,1900,True,92,143,sebsi:1  
1,11,2,90,5,586,273,700,1,426,273,700,0,0,266,3,4,273,0,1827,1935,True,122,144,sebsi:1  marzouki:1  
1,11,2,90,4,586,323,700,0,377,323,700,0,0,318,4,1,323,0,1815,1900,True,147,171,sebsi:1  marzouki:1  
1,11,2,90,3,586,339,700,0,361,339,700,0,0,328,5,6,339,0,1825,1950,True,173,155,sebsi:1  
1,11,2,90,2,586,347,700,0,353,347,700,0,0,334,5,8,347,0,1812,1905,True,199,135,sebsi:1  marzouki:1  
1,11,2,90,1,586,355,700,0,345,355,700,0,0,336,7,12,355,0,1815,1845,True,210,126,sebsi:1  
1,11,2,89,7,579,306,700,0,394,306,700,0,0,298,4,4,306,0,1810,1905,True,149,149,sebsi:1  
1,11,2,89,6,583,231,700,0,469,231,700,0,0,225,4,2,231,0,1815,1845,True,107,118,sebsi:1  
1,11,2,89,5,583,288,700,1,411,288,700,0,0,284,4,0,288,0,,1900,True,157,127,sebsi:1  
1,11,2,89,4,583,314,700,0,386,314,700,0,0,308,2,4,314,0,1820,1915,True,172,136,sebsi:1  
1,11,2,89,3,583,355,700,0,345,355,700,0,0,346,6,3,355,0,1825,,True,213,133,sebsi:1  
1,11,2,89,2,583,355,700,0,345,355,700,0,0,343,8,4,355,0,1805,1850,True,206,137,sebsi:1  
1,11,2,89,1,583,393,700,0,307,393,700,0,0,374,12,7,393,0,1815,2005,False,249,125,sebsi:1  marzouki:1  
1,11,2,88,5,496,214,600,0,386,214,600,0,0,208,4,2,214,0,1825,1850,True,100,108,sebsi:1  
1,11,2,88,4,499,200,600,0,400,200,600,0,0,194,3,3,200,0,1825,1854,True,88,106,sebsi:1  marzouki:1  
1,11,2,88,3,499,257,600,0,343,257,600,0,0,253,1,3,257,0,1830,1900,True,121,132,sebsi:1  marzouki:1  
1,11,2,88,2,499,273,601,0,328,273,601,0,0,267,3,3,273,0,1820,1852,True,173,94,sebsi:1  
1,11,2,88,1,499,326,600,0,274,326,600,0,0,319,2,5,326,0,1815,1905,True,188,131,sebsi:1  
1,11,1,87,2,333,208,400,1,191,208,400,0,0,203,2,3,208,0,1815,1845,True,80,123,sebsi:1  marzouki:1  
1,11,1,87,1,334,216,396,0,180,216,396,0,0,207,7,2,216,0,,,True,131,76,sebsi:1  
1,10,3,86,4,554,314,600,1,285,314,600,0,0,310,4,0,314,0,1815,1930,True,158,152,sebsi:1  marzouki:1  
1,10,3,86,3,556,320,600,1,279,320,600,0,0,313,6,1,320,0,1820,1905,True,149,164,sebsi:1  marzouki:1  
1,10,3,86,2,556,340,600,2,258,340,600,0,0,329,7,4,340,0,1835,1910,True,194,135,sebsi:1  marzouki:1  
1,10,3,86,1,556,418,599,1,180,418,599,0,0,404,6,8,418,0,1815,1920,True,263,141,sebsi:1  marzouki:1  
1,10,3,85,7,588,305,700,2,393,305,700,0,0,297,6,2,305,0,1825,1925,True,139,158,sebsi:1  
1,10,3,85,6,590,275,700,0,425,275,700,0,0,266,7,2,275,0,1800,1930,True,100,166,sebsi:1  marzouki:1  
1,10,3,85,5,590,374,700,0,326,374,700,0,0,359,7,8,374,0,1830,1915,True,153,206,sebsi:1  marzouki:1  
1,10,3,85,4,590,347,700,2,351,347,700,0,0,330,13,4,347,0,1830,2000,True,168,162,sebsi:1  marzouki:1  
1,10,3,85,3,590,379,700,2,319,379,700,0,0,368,6,5,379,0,1815,1930,True,215,153,sebsi:1  marzouki:1  
1,10,3,85,2,590,369,700,0,331,369,700,0,0,347,6,16,369,0,1815,1905,True,217,130,sebsi:1  marzouki:1  
1,10,3,85,1,590,377,700,3,320,377,700,0,0,344,27,6,377,0,1830,1937,True,214,130,sebsi:1  marzouki:1  
1,10,2,84,6,552,355,600,0,245,355,600,0,0,346,3,6,355,0,1830,1910,True,220,126,sebsi:1  marzouki:1  
1,10,2,84,5,555,403,600,0,197,403,600,0,0,395,6,2,403,0,1830,1930,True,228,167,sebsi:1  marzouki:1  
1,10,2,84,4,555,388,600,0,212,388,600,0,0,382,3,3,388,0,1820,1920,True,247,135,sebsi:1  marzouki:1  
1,10,2,84,2,555,445,600,0,155,445,600,0,0,434,7,4,445,0,1841,2030,True,302,132,sebsi:1  marzouki:1  
1,10,2,84,1,555,438,603,2,163,438,603,0,0,429,8,1,438,0,180,2015,True,327,102,sebsi:1  marzouki:1  
1,10,2,83,2,512,339,600,0,261,339,600,0,0,329,7,3,339,0,1850,1945,True,201,128,sebsi:1  marzouki:1  
1,10,2,83,1,512,400,600,1,199,400,600,0,0,392,5,3,400,0,1900,1940,True,277,115,sebsi:1  marzouki:1  
1,10,1,82,6,565,368,600,2,230,368,600,0,0,358,5,5,368,0,1830,1940,True,178,180,sebsi:1  marzouki:1  
1,10,1,82,5,568,388,600,0,212,388,600,0,0,382,4,2,388,0,1830,1925,True,215,167,sebsi:1  marzouki:1  
1,10,1,82,4,568,358,600,0,242,358,600,0,0,350,1,7,358,0,1840,1915,True,187,163,sebsi:1  marzouki:1  
1,10,1,82,3,568,383,600,0,218,382,600,0,1,371,8,3,382,0,1845,1945,True,209,162,sebsi:1  marzouki:1  
1,10,1,82,2,568,392,600,3,205,392,600,0,0,372,11,9,392,0,1845,2000,True,237,135,sebsi:1  marzouki:1  
1,10,1,82,1,568,392,700,0,308,392,700,0,0,381,10,1,392,0,1840,1945,True,273,108,sebsi:1  
1,10,1,81,2,575,368,700,1,331,368,700,0,0,358,5,5,368,0,1847,1835,True,212,146,sebsi:1  marzouki:1  
1,10,1,81,1,575,407,600,3,190,407,600,0,0,394,7,6,407,0,1845,2000,True,270,124,sebsi:1  marzouki:1  
1,5,5,55,5,513,319,600,0,281,319,600,0,0,313,2,4,319,0,1815,1930,True,181,132,sebsi:1  marzouki:1  
1,5,5,55,4,515,297,600,0,303,297,600,0,0,283,5,9,297,0,1810,1852,True,180,103,sebsi:1  marzouki:1  
1,5,5,55,3,515,338,600,0,262,338,600,0,0,326,8,4,338,0,1815,1910,True,211,115,sebsi:1  marzouki:1  
1,5,5,55,2,515,358,600,7,235,358,600,0,0,353,3,2,358,0,1810,1916,True,250,103,sebsi:1  marzouki:1  
1,5,5,55,1,515,381,600,2,217,381,600,0,0,376,3,2,381,0,1810,1915,True,275,101,sebsi:1  marzouki:1  
1,5,4,54,3,563,329,600,0,271,329,600,0,0,322,5,2,329,0,1815,1910,True,157,165,sebsi:1  marzouki:1  
1,5,4,54,2,565,359,603,2,242,359,603,0,0,350,6,3,359,0,1830,1934,True,199,151,sebsi:1  marzouki:1  
1,5,4,54,1,565,386,600,0,215,385,600,0,1,374,7,4,385,0,1835,1915,True,260,114,sebsi:1  marzouki:1  
1,5,3,53,7,586,331,700,1,368,331,700,0,0,322,4,5,331,0,1830,1940,True,169,153,sebsi:1  marzouki:1  
1,5,3,53,6,590,393,700,0,307,393,700,0,0,374,10,9,393,0,1830,1945,True,234,140,sebsi:1  marzouki:1  
1,5,3,53,5,590,359,700,0,341,359,700,0,0,343,11,5,359,0,,1955,True,218,125,sebsi:1  marzouki:1  
1,5,3,53,4,590,393,700,0,307,393,700,0,0,386,2,5,393,0,1840,1955,True,232,154,sebsi:1  marzouki:1  
1,5,3,53,3,590,437,700,1,262,437,700,0,0,425,8,4,437,0,1830,1950,True,284,141,sebsi:1  marzouki:1  
1,5,3,53,2,590,443,700,0,257,443,700,0,0,436,3,4,443,0,1800,2015,True,303,133,sebsi:1  marzouki:1  
1,5,3,53,1,590,438,700,1,261,438,700,0,0,425,7,6,438,0,1805,1925,True,304,121,sebsi:1  marzouki:1  
1,5,2,52,3,562,357,597,1,239,357,597,0,0,348,3,6,357,0,1835,1915,True,192,156,sebsi:1  marzouki:1  
1,5,2,52,2,564,382,599,1,216,382,599,0,0,373,5,4,382,0,1830,1939,True,216,157,sebsi:1  marzouki:1  
1,5,2,52,1,564,431,600,1,168,431,600,0,0,416,10,5,431,0,1833,2005,True,298,118,sebsi:1  marzouki:1  
1,5,2,51,3,516,314,596,0,282,314,596,0,0,304,9,1,314,0,1830,2007,True,159,145,sebsi:1  marzouki:1  
1,5,2,51,2,517,361,600,2,237,361,600,0,0,356,4,1,361,0,1833,2045,True,219,137,sebsi:1  marzouki:1  
1,5,2,51,1,517,394,592,0,198,394,592,0,0,381,9,4,394,0,1830,1930,True,277,104,sebsi:1  marzouki:1  
1,5,1,50,7,556,285,600,1,314,285,600,0,0,279,3,3,285,0,1820,1930,True,132,147,sebsi:1  marzouki:1  
1,5,1,50,6,561,337,600,1,262,337,600,0,0,327,6,4,337,0,1830,1915,True,197,130,sebsi:1  marzouki:1  
1,5,1,50,5,561,352,596,0,244,352,596,0,0,339,9,4,352,0,1830,1930,True,189,150,sebsi:1  marzouki:1  
1,5,1,50,4,561,375,600,1,224,375,600,0,0,369,4,2,375,0,,2000,True,198,171,sebsi:1  marzouki:1  
1,5,1,50,3,561,388,600,0,212,388,600,0,0,382,2,4,388,0,1820,1900,True,262,120,sebsi:1  marzouki:1  
1,5,1,50,2,561,413,600,3,184,413,600,0,0,407,3,3,413,0,1830,1925,True,262,145,sebsi:1  marzouki:1  
1,5,1,50,1,561,400,600,1,199,400,600,0,0,394,5,1,400,0,1830,1925,True,286,108,sebsi:1  marzouki:1  
1,9,4,80,3,486,223,600,0,377,223,600,0,0,218,4,1,223,0,1815,1900,True,115,103,sebsi:1  marzouki:1  
1,9,4,80,2,486,291,600,1,308,291,600,0,0,273,17,1,291,0,1815,1905,True,154,119,sebsi:1  marzouki:1  
1,9,4,80,1,486,321,600,1,278,321,600,0,0,291,20,10,321,0,1820,1920,True,191,100,sebsi:1  marzouki:1  
1,9,4,79,7,571,306,703,0,397,306,703,0,0,293,5,8,306,0,1825,,True,117,176,sebsi:1  marzouki:1  
1,9,4,79,6,574,309,700,3,388,309,700,0,0,302,6,1,309,0,1815,1910,True,146,156,sebsi:1  marzouki:1  
1,9,4,79,5,574,366,700,0,334,366,700,0,0,355,5,6,366,0,1825,1930,True,166,189,sebsi:1  marzouki:1  
1,9,4,79,4,574,381,699,0,318,381,699,0,0,366,13,2,381,0,1820,1945,True,205,161,sebsi:1  marzouki:1  
1,9,4,79,3,574,399,700,2,299,399,700,0,0,373,17,9,399,0,1826,1930,True,218,155,sebsi:1  marzouki:1  
1,9,4,79,2,574,384,700,5,311,384,700,0,0,352,25,7,384,0,1815,1910,True,225,127,sebsi:1  marzouki:1  
1,9,4,79,1,574,406,700,4,290,406,700,0,0,374,19,13,406,0,1820,1943,True,266,108,sebsi:1  marzouki:1  
1,9,3,78,3,547,318,600,0,282,318,600,0,0,311,5,2,318,0,1830,2000,True,140,171,sebsi:1  marzouki:1  
1,9,3,78,2,548,394,600,1,205,394,600,0,0,385,6,3,394,0,1830,1930,True,210,175,sebsi:1  marzouki:1  
1,9,3,78,1,548,395,600,0,205,395,600,0,0,376,16,3,395,0,1810,2000,True,238,138,sebsi:1  marzouki:1  
1,9,2,77,3,513,293,600,1,306,293,600,0,0,286,6,1,293,0,,1915,True,157,129,sebsi:1  marzouki:1  
1,9,2,77,2,513,319,599,1,279,319,599,0,0,308,5,6,319,0,1835,1948,True,191,117,sebsi:1  marzouki:1  
1,9,2,77,1,513,348,600,1,251,348,600,0,0,338,8,2,348,0,1900,2025,True,253,85,sebsi:1  marzouki:1  
1,9,2,76,4,492,255,600,0,345,255,600,0,0,247,5,3,255,0,1805,1840,True,138,109,sebsi:1  marzouki:1  
1,9,2,76,3,493,324,600,0,276,324,600,0,0,313,9,2,324,0,1815,1917,True,180,133,sebsi:1  marzouki:1  
1,9,2,76,2,493,320,600,1,279,320,600,0,0,305,9,6,320,0,1850,2015,True,187,118,sebsi:1  marzouki:1  
1,9,2,76,1,493,360,600,1,240,359,600,0,1,343,5,11,359,0,1830,2025,True,256,87,sebsi:1  marzouki:1  
1,9,1,75,3,406,238,500,0,262,238,500,0,0,232,5,1,238,0,1815,1915,True,120,112,sebsi:1  marzouki:1  
1,9,1,75,2,406,279,501,0,222,279,501,0,0,274,4,1,279,0,1820,1933,True,162,112,sebsi:1  marzouki:1  
1,9,1,75,1,406,302,500,0,198,302,500,0,0,286,10,6,302,0,1815,1900,True,186,100,sebsi:1  marzouki:1  
1,2,6,28,2,308,207,400,0,193,207,400,0,0,204,2,1,207,0,1835,1925,True,105,99,sebsi:1  marzouki:1  
1,2,6,28,1,309,217,400,0,183,217,400,0,0,207,8,2,217,0,1830,1925,True,108,99,sebsi:1  marzouki:1  
1,2,6,27,5,589,374,700,0,326,374,700,0,0,363,6,5,374,0,1805,1915,True,198,165,sebsi:1  marzouki:1  
1,2,6,27,4,590,344,700,1,355,344,700,0,0,333,5,6,344,0,1816,1916,True,186,147,sebsi:1  marzouki:1  
1,2,6,27,3,590,406,700,0,294,406,700,0,0,398,3,5,406,0,1815,1930,True,221,177,sebsi:1  marzouki:1  
1,2,6,27,2,590,433,700,2,265,433,700,0,0,421,9,3,433,0,1815,1935,True,249,172,sebsi:1  marzouki:1  
1,2,6,27,1,590,455,700,1,244,455,700,0,0,443,9,3,455,0,1805,1955,False,292,151,sebsi:1  marzouki:1  
1,2,5,26,1,421,274,500,0,226,274,500,0,0,267,6,1,274,0,0,2015,True,145,122,sebsi:1  marzouki:1  
1,2,5,25,2,585,388,700,1,312,387,700,0,1,377,8,2,387,0,1813,1906,True,199,178,sebsi:1  marzouki:1  
1,2,5,24,5,552,307,600,0,293,307,600,0,0,295,8,4,307,0,1815,1945,True,132,163,sebsi:1  marzouki:1  
1,2,5,24,4,556,307,600,1,292,307,600,0,0,293,7,7,307,0,1810,1845,True,132,161,sebsi:1  marzouki:1  
1,2,5,24,3,556,371,600,0,229,371,600,0,0,365,3,3,371,0,1815,1845,True,168,197,sebsi:1  marzouki:1  
1,2,5,24,2,556,395,600,0,205,395,600,0,0,372,13,10,395,0,1820,1915,True,196,176,sebsi:1  marzouki:1  
1,2,5,24,1,556,383,600,0,217,383,600,0,0,370,12,1,383,0,1815,1925,True,214,156,sebsi:1  marzouki:1  
1,2,4,23,5,565,327,600,0,273,327,600,0,0,318,7,2,327,0,1815,1900,True,182,136,sebsi:1  marzouki:1  
1,2,4,23,4,569,349,600,1,250,349,600,0,0,345,0,4,349,0,1810,1857,True,181,164,sebsi:1  marzouki:1  
1,2,4,23,2,569,410,600,2,188,410,600,0,0,402,4,4,410,0,1800,1900,True,236,166,sebsi:1  marzouki:1  
1,2,4,23,1,569,420,600,0,180,420,600,0,0,401,19,0,420,0,1800,1920,True,253,148,sebsi:1  marzouki:1  
1,2,3,22,3,466,314,500,0,186,314,500,0,0,307,2,5,314,0,1815,1900,True,131,176,sebsi:1  marzouki:1  
1,2,3,22,2,466,340,500,0,160,340,500,0,0,329,3,8,340,0,1815,1915,True,167,162,sebsi:1  marzouki:1  
1,2,3,22,1,466,345,498,1,152,345,498,0,0,339,3,3,345,0,1820,1925,True,213,126,sebsi:1  marzouki:1  
1,2,2,21,6,524,322,600,0,278,322,600,0,0,316,3,3,322,0,1820,1900,True,148,168,sebsi:1  marzouki:1  
1,2,2,21,5,524,310,600,0,290,310,600,0,0,299,8,3,310,0,1830,1936,True,169,130,sebsi:1  marzouki:1  
1,2,2,21,4,524,336,602,2,264,336,602,0,0,327,7,2,336,0,1830,1930,True,185,142,sebsi:1  marzouki:1  
1,2,2,21,3,524,374,600,1,225,374,600,0,0,364,6,4,374,0,1831,1950,True,202,162,sebsi:1  marzouki:1  
1,2,2,21,2,524,392,600,8,200,392,600,0,0,345,44,3,392,0,1820,2000,True,204,141,sebsi:1  marzouki:1  
1,2,2,21,1,524,383,600,2,215,383,600,0,0,366,13,4,383,0,,,True,251,115,sebsi:1  marzouki:1  
1,2,1,20,8,544,314,600,3,283,314,600,0,0,307,6,1,314,0,1830,1915,True,157,150,sebsi:1  marzouki:1  
1,2,1,20,7,549,341,600,0,259,341,600,0,0,332,7,2,341,0,1830,1920,True,187,145,sebsi:1  marzouki:1  
1,2,1,20,6,549,374,600,0,226,374,600,0,0,369,3,2,374,0,,1915,True,211,158,sebsi:1  marzouki:1  
1,2,1,20,5,549,396,600,0,204,396,600,0,0,388,4,4,396,0,1815,1915,True,231,157,sebsi:1  marzouki:1  
1,2,1,20,4,549,385,600,2,213,385,600,0,0,376,4,5,385,0,1840,1950,True,233,143,sebsi:1  marzouki:1  
1,2,1,20,3,549,417,599,2,180,417,599,0,0,411,5,1,417,0,1900,0,True,246,165,sebsi:1  marzouki:1  
1,2,1,20,2,549,400,600,2,198,400,600,0,0,386,9,5,400,0,0,1950,True,264,122,sebsi:1  marzouki:1  
1,3,2,31,3,470,237,500,0,264,237,501,1,0,229,5,3,237,0,1830,1930,True,110,119,sebsi:1  marzouki:1  
1,3,2,31,2,470,288,500,0,212,288,500,0,0,280,6,2,288,0,1815,1902,True,142,138,sebsi:1  marzouki:1  
1,3,2,30,3,574,252,700,0,448,252,700,0,0,249,1,2,252,0,1825,1910,True,109,140,sebsi:1  marzouki:1  
1,3,1,29,8,580,325,700,1,374,325,700,0,0,322,3,0,325,0,180,1930,True,157,165,sebsi:1  marzouki:1  
1,3,1,29,7,584,301,700,0,399,301,700,0,0,294,2,5,301,0,1837,1929,True,144,150,sebsi:1  marzouki:1  
1,3,1,29,6,584,318,700,0,382,318,700,0,0,307,3,8,318,0,1820,1925,True,144,163,sebsi:1  marzouki:1  
1,3,1,29,5,584,398,701,0,303,398,701,0,0,390,2,6,398,0,1815,1915,True,178,212,sebsi:1  marzouki:1  
1,3,1,29,4,584,346,700,2,352,346,700,0,0,328,6,12,346,0,1830,1920,True,176,152,sebsi:1  marzouki:1  
1,3,1,29,3,584,387,700,1,312,387,700,0,0,371,7,9,387,0,1830,1920,True,201,170,sebsi:1  marzouki:1  
1,3,1,29,2,584,372,700,1,328,371,700,0,1,359,10,2,371,0,1830,2048,True,213,146,sebsi:1  marzouki:1  
1,3,1,29,1,584,406,700,1,293,406,700,0,0,398,8,0,406,0,1830,2001,True,260,138,sebsi:1  marzouki:1  
1,6,5,62,6,514,312,600,1,287,312,600,0,0,306,5,1,312,0,1835,1930,True,142,164,sebsi:1  marzouki:1  
1,6,5,62,5,519,337,600,2,261,337,600,0,0,326,6,5,337,0,1833,1926,True,167,159,sebsi:1  marzouki:1  
1,6,5,62,4,519,283,600,0,317,283,600,0,0,271,7,5,283,0,1829,1929,True,135,136,sebsi:1  marzouki:1  
1,6,5,62,3,519,339,600,0,261,339,600,0,0,331,2,6,339,0,1830,1950,True,195,136,sebsi:1  marzouki:1  
1,6,5,62,2,519,340,600,1,259,340,600,0,0,324,9,7,340,0,1820,1950,True,206,118,sebsi:1  marzouki:1  
1,6,5,62,1,519,330,599,0,269,330,599,0,0,316,12,2,330,0,1830,1930,True,215,101,sebsi:1  marzouki:1  
1,6,4,61,3,474,315,500,0,185,315,500,0,0,305,5,5,315,0,1815,1915,True,115,190,sebsi:1  marzouki:1  
1,6,4,61,2,474,297,499,0,202,297,499,0,0,287,6,4,297,0,,1940,True,117,170,sebsi:1  marzouki:1  
1,6,4,61,1,474,332,500,1,167,332,500,0,0,322,5,5,332,0,1825,1925,True,165,157,sebsi:1  marzouki:1  
1,6,4,60,4,558,367,600,6,227,367,600,0,0,357,6,4,367,0,1810,1910,True,161,196,sebsi:1  marzouki:1  
1,6,4,60,3,561,356,599,0,243,356,599,0,0,347,7,2,356,0,1805,2015,True,162,185,sebsi:1  marzouki:1  
1,6,4,60,2,561,444,596,0,152,444,596,596,0,433,5,6,444,0,1810,1905,True,206,227,sebsi:1  marzouki:1  
1,6,3,59,4,522,426,596,2,168,426,596,0,0,419,3,4,426,0,1800,2020,True,237,182,sebsi:1  marzouki:1  
1,6,3,59,1,522,412,600,0,188,412,600,0,0,401,8,3,412,0,1830,2005,True,270,131,sebsi:1  marzouki:1  
1,6,3,58,3,435,330,500,1,169,330,500,0,0,328,1,1,330,0,1830,1930,True,168,160,sebsi:1  marzouki:1  
1,6,3,58,2,437,297,500,1,202,297,500,0,0,292,3,2,297,0,1830,1910,True,148,144,sebsi:1  marzouki:1  
1,6,3,58,1,437,341,491,0,150,341,491,0,0,328,9,4,341,0,1825,1930,True,188,140,sebsi:1  marzouki:1  
1,6,2,57,6,573,396,700,0,304,396,700,0,0,383,9,4,396,0,1840,2010,True,194,189,sebsi:1  marzouki:1  
1,6,2,57,5,574,405,700,0,296,404,700,0,1,396,5,3,404,0,1830,1950,True,204,192,sebsi:1  marzouki:1  
1,6,2,57,4,574,364,700,1,335,364,700,0,0,355,5,4,364,0,1830,1920,True,187,168,sebsi:1  marzouki:1  
1,6,2,57,3,574,420,700,3,277,420,700,0,0,415,3,2,420,0,1845,2010,True,222,193,sebsi:1  marzouki:1  
1,6,2,57,2,574,435,698,0,263,435,698,0,0,421,11,3,435,0,1814,1957,True,280,141,sebsi:1  :1  
1,6,2,57,1,574,428,700,5,267,428,700,0,0,413,12,3,428,0,1845,2000,True,257,156,sebsi:1  :1  
1,6,1,56,3,532,383,600,1,216,383,600,0,0,369,7,7,383,0,1840,1940,True,209,160,sebsi:1  marzouki:1  
1,6,1,56,2,532,386,600,0,214,386,600,0,0,374,11,1,386,0,1814,1930,True,234,140,sebsi:1  marzouki:1  
1,6,1,56,1,532,404,600,2,194,404,600,0,0,395,4,5,404,0,1810,1915,True,250,145,sebsi:1  marzouki:1  
1,4,8,49,2,301,190,396,1,205,190,396,0,0,189,0,1,190,0,1815,1847,True,94,95,sebsi:1  marzouki:1  
1,4,8,48,3,593,335,700,4,361,335,700,0,0,318,10,7,335,0,1830,1945,True,173,145,sebsi:1  marzouki:1  
1,4,8,48,2,594,412,700,0,288,412,700,0,0,400,6,6,412,0,1815,2000,True,212,188,sebsi:1  marzouki:1  
1,4,8,48,1,594,455,701,0,246,455,701,0,0,442,6,7,455,0,1840,1938,True,276,166,sebsi:1  marzouki:1  
1,4,8,47,8,552,347,599,0,252,347,599,0,0,338,5,4,347,0,1815,1910,True,148,190,sebsi:1  marzouki:1  
1,4,8,47,7,554,312,600,0,288,312,600,0,0,300,9,3,312,0,1815,1910,True,168,132,sebsi:1  marzouki:1  
1,4,8,47,6,554,345,596,0,251,345,596,0,0,333,6,6,345,0,1800,1910,True,180,153,sebsi:1  marzouki:1  
1,4,8,47,5,554,381,600,1,218,381,600,0,0,372,6,3,381,0,1810,1920,True,202,170,sebsi:1  marzouki:1  
1,4,8,47,4,554,391,596,0,205,391,596,0,0,384,4,3,391,0,1800,1845,True,197,187,sebsi:1  marzouki:1  
1,4,8,47,3,554,424,601,1,176,424,601,0,0,419,4,1,424,0,1830,1920,True,234,185,sebsi:1  marzouki:1  
1,4,8,47,2,554,422,596,1,173,422,596,0,0,410,9,3,422,0,1800,1910,True,258,152,sebsi:1  marzouki:1  
1,4,8,47,1,554,446,604,3,155,446,604,0,0,434,9,3,446,0,1815,1930,True,282,152,sebsi:1  marzouki:1  
1,4,7,46,2,531,368,600,0,232,368,600,0,0,357,8,3,368,0,1830,1930,True,161,196,sebsi:1  marzouki:1  
1,4,7,46,1,532,428,600,0,172,428,600,0,0,422,3,3,428,0,1830,2015,True,235,187,sebsi:1  marzouki:1  
1,4,7,45,2,357,231,400,0,169,231,400,0,0,222,8,1,231,0,1830,,True,129,93,sebsi:1  marzouki:1  
1,4,7,45,1,357,275,392,1,116,275,392,0,0,269,3,3,275,0,1830,2000,True,166,103,sebsi:1  marzouki:1  
1,4,7,44,2,334,239,396,0,158,238,396,0,1,235,2,1,238,0,1815,1845,True,112,123,sebsi:1  marzouki:1  
1,4,7,44,1,334,275,392,0,117,275,392,0,0,269,3,3,275,0,1810,1835,True,141,128,sebsi:1  marzouki:1  
1,4,7,43,5,541,379,600,3,218,379,600,0,0,370,7,2,379,0,1815,1919,True,188,182,sebsi:1  marzouki:1  
1,4,7,43,4,544,387,600,0,213,387,600,0,0,379,6,2,387,0,1812,1900,True,199,180,sebsi:1  marzouki:1  
1,4,7,43,3,544,424,596,1,171,424,596,0,0,413,8,3,424,0,1830,1901,True,183,230,sebsi:1  marzouki:1  
1,4,7,43,2,544,442,596,0,154,442,596,0,0,435,6,1,442,0,1815,1917,True,227,208,sebsi:1  marzouki:2  
1,4,7,43,1,544,449,600,0,151,449,600,0,0,438,9,2,449,0,,1915,True,261,177,sebsi:1  marzouki:1  
1,4,6,42,4,454,292,501,0,209,292,501,0,0,282,7,3,292,0,1820,1900,True,121,161,sebsi:1  marzouki:1  
1,4,6,42,3,455,320,500,0,180,320,500,0,0,313,6,1,320,0,1825,1920,True,149,164,sebsi:1  marzouki:1  
1,4,6,42,2,455,340,508,0,168,340,508,0,0,337,3,0,340,0,,1915,True,164,173,sebsi:1  marzouki:1  
1,4,6,42,1,455,382,500,0,118,382,500,0,0,375,5,2,382,0,1830,1930,True,212,163,sebsi:1  
1,4,6,41,6,561,333,600,0,267,333,600,0,0,310,16,7,333,0,1830,2030,True,156,154,sebsi:1  marzouki:1  
1,4,6,41,5,562,354,600,1,245,354,600,0,0,342,9,3,354,0,1840,2005,True,186,156,sebsi:1  marzouki:1  
1,4,6,41,4,562,380,600,0,220,380,600,0,0,373,5,2,380,0,1837,1935,True,165,208,sebsi:1  marzouki:1  
1,4,6,41,3,562,389,596,1,206,389,596,0,0,383,4,2,389,0,1830,2005,True,212,171,sebsi:1  marzouki:1  
1,4,6,41,2,562,430,596,0,166,430,596,0,0,421,3,6,430,0,1830,1930,True,268,153,sebsi:1  marzouki:1  
1,4,6,41,1,562,417,600,0,183,417,600,0,0,410,6,1,417,0,1830,1950,True,271,139,sebsi:1  marzouki:1  
1,4,5,40,3,543,269,600,0,331,269,600,0,0,257,8,4,269,0,1815,1900,True,69,188,sebsi:1  marzouki:1  
1,4,5,40,2,545,363,600,0,237,363,600,0,0,358,4,1,363,0,1815,1930,True,138,220,sebsi:1  marzouki:1  
1,4,5,39,1,443,294,500,0,206,294,500,0,0,286,4,4,294,0,1815,1915,True,148,138,sebsi:1  marzouki:1  
1,4,4,38,2,404,244,500,0,256,244,500,0,0,240,1,3,244,0,1820,1900,True,112,128,sebsi:1  marzouki:1  
1,4,4,38,1,405,292,501,0,209,292,501,0,0,290,2,0,292,0,1815,1856,True,175,115,sebsi:1  marzouki:1  
1,4,4,37,2,417,276,500,0,224,276,500,0,0,269,4,3,276,0,1810,1903,True,122,147,sebsi:1  marzouki:1  
1,4,4,37,1,413,308,500,2,190,308,500,0,0,294,11,3,308,0,1821,1924,True,174,120,sebsi:1  marzouki:1  
1,4,4,36,4,593,323,699,0,376,323,699,0,0,304,15,4,323,0,1830,1940,True,148,156,sebsi:1  marzouki:1  
1,4,4,36,3,596,391,700,2,307,391,700,0,0,380,8,3,391,0,1830,2000,True,186,194,sebsi:1  marzouki:1  
1,4,4,36,2,596,411,700,3,286,411,700,0,0,397,7,7,411,0,1830,2000,True,226,171,sebsi:1  marzouki:1  
1,4,4,36,1,596,405,700,2,293,405,700,0,0,400,5,0,405,0,1830,1920,True,256,144,sebsi:1  marzouki:1  
1,4,4,35,6,573,337,700,0,363,337,700,0,0,322,8,7,337,0,1830,1920,True,148,174,sebsi:1  marzouki:1  
1,4,4,35,5,574,359,700,1,340,359,700,0,0,355,2,2,359,0,,1920,True,126,229,sebsi:1  marzouki:1  
1,4,4,35,4,574,399,700,0,301,399,700,0,0,385,11,3,399,0,1810,1925,True,161,224,sebsi:1  
1,4,4,35,3,574,410,700,0,290,410,700,0,0,399,7,4,410,0,1815,1907,True,196,203,sebsi:1  marzouki:1  
1,4,4,35,2,574,421,700,0,279,421,700,0,0,411,9,1,421,0,1820,1925,True,212,199,sebsi:1  marzouki:1  
1,4,4,35,1,574,415,700,0,285,415,700,0,0,363,35,17,415,0,1815,1900,True,215,148,sebsi:1  marzouki:1  
1,4,3,34,5,528,272,596,1,323,272,596,0,0,261,6,5,272,0,1800,1850,True,116,145,sebsi:1  marzouki:1  
1,4,3,34,4,531,306,600,1,293,306,600,0,0,299,6,1,306,0,1820,1900,True,133,166,sebsi:1  marzouki:1  
1,4,3,34,3,531,329,600,0,271,329,600,0,0,319,6,4,329,0,1820,1945,True,137,182,sebsi:1  marzouki:1  
1,4,3,34,2,531,365,607,1,241,365,607,0,0,361,1,3,365,0,1815,1915,True,199,162,sebsi:1  marzouki:1  
1,4,3,34,1,531,377,600,0,223,377,600,0,0,362,11,4,377,0,1820,2010,True,235,127,sebsi:1  marzouki:1  
1,4,2,33,7,525,287,600,0,313,287,600,0,0,280,5,2,287,0,1815,1900,True,137,143,sebsi:1  marzouki:1  
1,4,2,33,6,525,311,600,0,289,311,600,0,0,307,2,2,311,0,1825,2000,True,144,163,sebsi:1  marzouki:1  
1,4,2,33,5,525,358,600,0,242,358,600,0,0,350,3,5,358,0,1820,1925,True,149,201,sebsi:1  marzouki:1  
1,4,2,33,4,525,380,601,0,221,380,601,0,0,367,11,2,380,0,1825,1925,True,197,170,sebsi:1  marzouki:1  
1,4,2,33,3,525,372,600,0,228,372,600,0,0,363,4,5,372,0,1830,1930,True,205,158,sebsi:1  marzouki:0  
1,4,2,33,2,525,372,600,0,282,372,600,0,0,361,4,7,372,0,1810,1920,True,205,156,sebsi:1  marzouki:1  
1,4,2,33,1,525,375,593,1,217,375,593,0,0,356,10,9,375,0,1815,1913,True,226,130,sebsi:1  marzouki:1  
1,4,1,32,2,526,349,600,0,251,349,600,0,0,340,4,5,349,0,1810,1900,True,163,177,sebsi:1  marzouki:1  
1,4,1,32,1,526,364,599,3,232,364,599,0,0,352,10,2,364,0,1810,1845,True,210,142,sebsi:1  marzouki:1  
1,1,9,19,3,597,313,700,0,387,313,700,0,0,309,2,2,313,0,1815,1915,True,128,181,sebsi:1  marzouki:1  
1,1,9,19,2,599,356,700,0,344,356,700,0,0,350,3,3,356,0,1820,1915,True,162,188,sebsi:1  marzouki:1  
1,1,9,19,1,599,429,700,4,267,429,700,0,0,413,8,8,429,0,1820,1940,True,230,183,sebsi:1  marzouki:1  
1,1,9,18,7,574,290,700,0,410,290,700,0,0,286,2,2,290,0,1850,2000,True,120,166,sebsi:1  marzouki:1  
1,1,9,18,6,580,303,700,0,397,303,700,0,0,297,3,3,303,0,1844,2019,True,121,176,sebsi:1  marzouki:1  
1,1,9,18,5,580,305,700,1,394,305,700,0,0,302,0,3,305,0,1820,1953,True,119,183,sebsi:1  marzouki:1  
1,1,9,18,4,580,382,700,0,316,384,700,0,2,379,3,2,384,0,1830,1945,True,175,204,sebsi:1  marzouki:1  
1,1,9,18,3,580,385,700,1,314,385,700,0,0,374,6,5,385,0,1850,1940,True,196,178,sebsi:1  marzouki:1  
1,1,9,18,2,580,389,700,2,309,389,700,0,0,382,3,4,389,0,1855,2000,True,196,186,sebsi:1  marzouki:1  
1,1,9,18,1,580,404,700,0,296,404,700,0,0,390,14,0,404,0,1900,2000,True,248,142,sebsi:1  marzouki:1  
1,1,9,17,4,579,332,700,0,368,332,700,0,0,323,5,4,332,0,1815,1932,True,138,185,sebsi:1  marzouki:1  
1,1,9,17,3,579,361,700,0,339,361,700,0,0,354,3,4,361,0,1835,1910,True,156,198,sebsi:1  marzouki:1  
1,1,9,17,2,579,399,700,2,299,399,700,0,0,394,2,3,399,0,1820,1920,True,205,189,sebsi:1  marzouki:1  
1,1,9,17,1,579,437,700,0,264,436,700,0,1,421,7,8,436,0,1830,1911,True,240,181,sebsi:1  marzouki:1  
1,1,8,16,4,491,305,600,0,295,305,600,0,0,300,3,2,305,0,1815,1915,True,128,172,sebsi:1  marzouki:1  
1,1,8,16,3,491,316,600,1,283,316,600,0,0,310,3,3,316,0,,1900,True,147,163,sebsi:1  marzouki:1  
1,1,8,16,2,491,363,600,0,237,363,600,0,0,354,6,3,363,0,1830,1910,True,185,169,sebsi:1  marzouki:1  
1,1,8,16,1,491,374,590,0,216,374,590,0,0,359,5,10,374,0,1815,1945,True,221,138,sebsi:1  marzouki:1  
1,1,7,15,6,519,338,599,0,261,338,599,0,0,335,1,2,338,0,1830,1940,True,164,171,sebsi:1  marzouki:1  
1,1,7,15,5,523,335,600,0,265,335,600,0,0,324,4,7,335,0,1830,1936,True,156,168,sebsi:1  marzouki:1  
1,1,7,15,4,523,346,596,0,250,346,596,0,0,340,2,4,346,0,1800,1957,True,162,178,sebsi:1  marzouki:1  
1,1,7,15,3,523,378,600,2,220,378,600,0,0,376,1,1,378,0,1830,1918,True,198,178,sebsi:1  marzouki:1  
1,1,7,15,2,523,386,600,3,211,386,600,0,0,370,6,10,386,0,1840,1945,True,180,190,sebsi:1  marzouki:1  
1,1,7,15,1,523,395,596,0,201,395,596,0,0,388,3,4,395,0,1830,1915,True,218,170,sebsi:1  marzouki:1  
1,1,6,14,5,533,338,600,1,268,331,600,0,0,324,4,3,331,0,1820,1923,True,178,146,sebsi:1  marzouki:1  
1,1,6,14,4,536,316,600,1,283,316,600,0,0,311,3,2,316,0,1830,1925,True,170,141,sebsi:1  marzouki:1  
1,1,6,14,3,536,359,594,2,233,359,594,0,0,349,8,2,359,0,1827,1906,True,188,161,sebsi:1  marzouki:1  
1,1,6,14,2,536,362,600,4,234,362,600,0,0,359,0,3,362,0,1820,1904,True,225,134,sebsi:1  marzouki:1  
1,1,6,14,1,536,392,610,4,214,392,610,0,0,378,14,0,392,0,1830,1940,True,250,128,sebsi:1  marzouki:1  
1,1,5,13,3,571,288,700,2,410,288,700,0,0,273,12,3,288,0,1810,1920,True,127,146,sebsi:1  marzouki:1  
1,1,5,13,2,572,370,700,0,330,370,700,0,0,362,5,3,370,0,1800,1917,True,148,214,sebsi:1  marzouki:1  
1,1,5,13,1,572,403,700,1,296,403,700,0,0,387,13,3,403,0,1824,1928,True,203,184,sebsi:1  marzouki:1  
1,1,4,12,4,490,350,600,0,250,350,600,0,0,348,0,2,350,0,1830,1915,True,141,207,sebsi:1  marzouki:1  
1,1,4,12,3,493,317,600,0,283,317,600,0,0,306,8,3,317,0,1810,1905,True,151,155,sebsi:1  marzouki:1  
1,1,4,12,2,493,360,600,0,240,360,600,0,0,357,1,2,360,0,1805,1910,True,162,195,sebsi:1  marzouki:1  
1,1,4,12,1,493,387,601,3,211,387,601,0,0,381,2,4,387,0,1815,1915,True,218,163,sebsi:1  marzouki:1  
1,1,3,11,2,344,206,400,0,194,206,400,0,0,203,0,3,206,0,1825,1900,True,124,79,sebsi:1  marzouki:1  
1,1,3,11,1,345,264,400,0,136,264,400,0,0,258,4,2,264,0,1830,1922,True,179,79,sebsi:1  marzouki:1  
1,1,3,10,8,547,319,600,1,280,319,600,0,0,316,1,2,319,0,1820,1915,True,159,157,sebsi:1  marzouki:1  
1,1,3,10,7,547,359,600,0,241,359,600,0,0,352,6,1,359,0,1830,1910,True,185,167,sebsi:1  marzouki:1  
1,1,3,10,6,547,339,596,0,257,339,596,0,0,331,3,5,339,0,1800,1910,True,180,151,sebsi:1  marzouki:1  
1,1,3,10,5,547,347,600,1,252,347,600,0,0,345,1,1,347,0,1815,1841,True,180,165,sebsi:1  marzouki:1  
1,1,3,10,4,547,412,600,1,187,412,600,0,0,409,2,1,412,0,1800,1920,True,237,172,sebsi:1  marzouki:1  
1,1,3,10,3,547,387,605,1,217,387,605,0,0,376,2,9,387,0,1816,1931,True,220,156,sebsi:1  marzouki:1  
1,1,3,10,2,547,408,600,2,191,407,600,0,1,395,7,5,407,0,1815,1941,True,261,134,sebsi:1  marzouki:1  
1,1,3,10,1,547,410,600,0,190,410,600,0,0,394,12,4,410,0,1820,1940,True,268,126,sebsi:1  marzouki:1  
1,1,2,9,4,543,284,600,1,315,284,600,0,0,277,5,2,284,0,1815,1900,True,120,157,sebsi:1  marzouki:1  
1,1,2,9,3,545,321,598,1,276,321,598,0,0,316,2,3,321,0,1835,1930,True,119,197,sebsi:1  marzouki:1  
1,1,2,9,2,545,364,599,0,235,364,599,0,0,357,3,4,364,0,1815,2015,True,203,154,sebsi:1  marzouki:1  
1,1,2,9,1,545,358,600,0,241,359,600,0,1,350,4,5,359,0,1815,1915,True,225,125,sebsi:1  marzouki:1  
1,1,2,8,2,566,323,600,0,277,323,600,0,0,315,5,3,323,0,1815,1923,True,166,149,sebsi:1  marzouki:1  
1,1,2,8,1,567,369,600,1,230,369,600,0,0,359,10,0,369,0,1830,1945,True,206,153,sebsi:1  marzouki:1  
1,1,2,7,6,553,311,600,1,288,311,600,0,0,306,2,3,311,0,1810,1840,True,97,209,sebsi:1  marzouki:1  
1,1,2,7,5,558,296,600,1,303,296,600,0,0,289,6,1,296,0,1810,1850,True,104,185,sebsi:1  marzouki:1  
1,1,2,7,4,558,330,600,0,270,330,600,0,0,330,0,0,330,0,1810,1840,True,134,196,sebsi:1  marzouki:1  
1,1,2,7,3,558,385,600,0,215,385,600,0,0,370,6,9,385,0,1810,1900,True,168,202,sebsi:1  marzouki:1  
1,1,2,7,1,558,404,600,0,196,404,600,0,0,392,11,1,404,0,1800,1925,True,225,167,sebsi:1  marzouki:1  
1,1,2,6,4,551,302,601,1,298,302,601,0,0,289,7,6,302,0,1815,2020,True,156,133,sebsi:1  marzouki:1  
1,1,2,6,3,553,364,601,0,37,364,601,0,0,353,5,6,364,0,1815,1900,True,190,163,sebsi:1  marzouki:1  
1,1,2,6,2,553,373,599,7,219,373,599,0,0,366,5,2,373,0,1810,1950,True,217,149,sebsi:1  marzouki:1  
1,1,2,6,1,553,377,602,0,225,377,602,0,0,359,11,7,377,0,1820,1915,True,221,138,sebsi:1  marzouki:1  
1,1,2,5,3,459,250,500,1,249,250,500,0,0,239,8,3,250,0,1830,1915,True,96,143,sebsi:1  marzouki:1  
1,1,2,5,2,500,300,500,0,200,300,500,0,0,296,0,4,300,0,1815,1900,True,141,155,sebsi:1  marzouki:1  
1,1,2,5,1,461,298,500,0,202,298,500,0,0,290,5,3,298,0,1840,1915,True,168,122,sebsi:1  marzouki:1  
1,1,2,4,5,593,336,700,0,364,336,700,0,0,332,2,3,337,1,1800,1930,True,170,162,sebsi:1  marzouki:1  
1,1,2,4,4,596,354,700,0,346,354,700,0,0,344,8,2,354,0,1809,1925,True,142,202,sebsi:1  marzouki:1  
1,1,2,4,3,596,406,700,0,294,406,700,0,0,402,2,2,406,0,1820,1930,True,184,218,sebsi:1  marzouki:1  
1,1,2,4,2,596,415,700,0,285,415,700,0,0,406,8,1,415,0,1815,1915,True,218,188,sebsi:1  marzouki:1  
1,1,2,4,1,596,435,700,2,263,435,700,0,0,417,7,11,435,0,1815,1930,True,259,158,sebsi:1  marzouki:1  
1,1,1,3,2,566,344,600,0,256,344,600,0,0,339,2,3,344,0,1805,1900,True,148,191,sebsi:1  marzouki:1  
1,1,1,3,1,567,407,600,4,189,407,600,0,0,388,17,2,407,0,1810,1935,True,219,169,sebsi:1  marzouki:1  
1,1,1,2,4,454,271,500,0,229,271,500,0,0,264,6,1,271,0,1815,1925,True,131,133,
1,1,1,2,3,456,302,505,1,202,302,505,0,0,298,2,2,302,0,1820,1920,True,139,159,sebsi:1  marzouki:1  
1,1,1,2,2,456,319,500,0,181,319,500,0,0,306,10,3,319,0,1830,1940,True,155,151,sebsi:1  marzouki:1  
1,1,1,2,1,456,347,500,0,153,347,500,0,0,339,6,2,347,0,1807,1900,True,218,121,sebsi:1  marzouki:1  
1,1,1,1,2,536,367,600,0,233,367,600,0,0,356,6,5,367,0,1810,1915,True,163,193,sebsi:1  marzouki:1  
1,1,1,1,1,536,361,600,3,236,361,600,0,0,348,9,4,361,0,1820,1915,True,220,128,sebsi:1  marzouki:1  
1,8,4,74,8,587,339,700,1,360,339,700,0,0,333,3,3,339,0,1855,2007,True,161,172,sebsi:1  marzouki:1  
1,8,4,74,7,592,380,700,0,320,380,700,0,0,369,7,4,380,0,1830,1925,True,184,185,sebsi:1  marzouki:1  
1,8,4,74,6,592,375,704,0,329,375,704,0,0,362,6,7,375,0,1820,1930,True,214,148,sebsi:1  marzouki:1  
1,8,4,74,5,592,436,700,2,262,436,700,0,0,426,8,2,436,0,1900,2004,True,241,185,sebsi:1  marzouki:1  
1,8,4,74,4,592,430,700,0,270,430,700,0,0,416,11,3,430,0,1830,1935,True,242,174,sebsi:1  marzouki:1  
1,8,4,74,3,592,432,701,0,269,432,701,0,0,416,14,2,432,0,1839,2005,True,280,136,sebsi:1  marzouki:1  
1,8,4,74,2,592,479,700,2,220,478,700,0,1,467,6,5,478,0,1845,2000,True,319,148,sebsi:1  marzouki:1  
1,8,4,74,1,592,453,700,0,247,453,700,0,0,437,11,5,453,0,1845,2015,True,278,159,sebsi:1  marzouki:1  
1,8,3,73,8,527,325,600,1,274,325,600,0,0,315,6,4,325,0,1820,1905,True,156,159,sebsi:1  marzouki:1  
1,8,3,73,7,530,341,601,0,260,341,601,0,0,336,1,4,341,0,0,1947,True,177,159,sebsi:1  marzouki:1  
1,8,3,73,6,530,345,600,0,255,345,600,0,0,337,4,4,345,0,0,1915,True,181,156,sebsi:1  marzouki:1  
1,8,3,73,5,530,383,600,0,217,383,600,0,0,370,7,6,383,0,1830,1900,True,203,167,sebsi:1  marzouki:1  
1,8,3,73,4,530,383,596,2,211,383,596,0,0,370,10,3,383,0,1840,1947,True,238,132,sebsi:1  marzouki:1  
1,8,3,73,3,530,416,600,0,184,416,600,0,0,396,11,9,416,0,1902,2011,True,237,159,sebsi:1  marzouki:1  
1,8,3,73,2,530,405,601,0,196,405,601,0,0,395,5,5,405,0,1848,2000,True,259,136,sebsi:1  marzouki:1  
1,8,3,73,1,530,410,600,1,189,410,600,0,0,398,6,6,410,0,1815,1945,True,243,155,sebsi:1  marzouki:1  
1,8,2,72,7,561,259,600,0,341,259,600,0,0,255,2,2,259,0,1835,1930,True,128,127,sebsi:1  marzouki:1  
1,8,2,72,6,563,325,600,2,273,325,600,0,0,318,6,1,325,0,1830,1930,True,186,132,sebsi:1  marzouki:1  
1,8,2,72,5,563,347,592,0,245,347,592,0,0,344,1,2,347,0,1840,1930,True,196,148,sebsi:1  marzouki:1  
1,8,2,72,4,563,358,600,1,241,358,600,0,0,351,3,4,358,0,1823,1910,True,225,126,sebsi:1  marzouki:1  
1,8,2,72,3,563,394,600,0,206,394,600,0,0,380,9,5,394,0,1820,1920,True,250,130,sebsi:1  marzouki:1  
1,8,2,72,2,563,390,600,0,210,390,600,0,0,380,2,8,390,0,1830,1930,True,281,99,sebsi:1  marzouki:1  
1,8,2,72,1,563,406,600,3,192,405,600,0,1,390,14,1,405,0,1830,1930,True,256,134,sebsi:1  marzouki:1  
1,8,1,71,8,557,282,600,0,318,282,600,0,0,276,4,2,282,0,1800,1910,True,140,136,sebsi:1  marzouki:1  
1,8,1,71,7,558,309,600,0,291,309,600,0,0,299,5,5,309,0,1815,1930,True,142,157,sebsi:1  marzouki:1  
1,8,1,71,6,558,357,600,1,242,357,600,0,0,345,5,7,357,0,1830,1930,True,196,149,sebsi:1  marzouki:1  
1,8,1,71,5,558,391,600,0,209,391,600,0,0,385,2,4,391,0,1825,1935,True,215,170,sebsi:1  marzouki:1  
1,8,1,71,4,558,366,600,0,234,366,600,0,0,357,8,1,366,0,1831,1923,True,217,140,sebsi:1  marzouki:1  
1,8,1,71,3,558,390,600,1,209,390,600,0,0,379,6,5,390,0,1830,1930,True,254,125,sebsi:1  marzouki:1  
1,8,1,71,2,558,425,600,0,175,425,600,0,0,410,12,3,425,0,1900,2040,True,286,124,sebsi:1  marzouki:1  
1,8,1,71,1,558,423,595,1,171,423,595,0,0,413,6,4,423,0,1810,1930,True,263,150,sebsi:1  marzouki:1  
1,7,6,70,7,547,295,600,1,304,295,600,0,0,281,4,10,295,0,1840,1930,True,150,131,sebsi:1  marzouki:1  
1,7,6,70,6,548,323,600,1,276,323,600,0,0,312,3,8,323,0,1900,1930,True,191,121,sebsi:1  marzouki:1  
1,7,6,70,5,548,366,600,1,833,366,600,0,0,358,5,3,366,0,1820,1940,True,227,131,sebsi:1  marzouki:1  
1,7,6,70,4,548,378,600,0,222,378,600,0,0,371,3,4,378,0,0,1935,True,235,136,sebsi:1  marzouki:1  
1,7,6,70,3,548,405,599,1,193,405,599,0,0,396,4,5,405,0,1800,1950,True,277,119,sebsi:1  marzouki:1  
1,7,6,70,2,548,399,608,4,205,399,608,0,1,388,6,5,399,0,1830,1900,True,294,94,sebsi:1  marzouki:1  
1,7,6,70,1,548,405,600,0,195,405,600,0,0,394,11,0,405,0,1835,1945,True,293,101,sebsi:1  marzouki:1  
1,7,5,69,5,487,267,600,1,332,267,600,0,0,258,8,1,267,0,1851,1935,True,168,90,sebsi:1  marzouki:1  
1,7,5,69,4,487,297,608,0,311,297,608,0,0,289,3,5,297,0,1825,1912,True,189,100,sebsi:1  marzouki:1  
1,7,5,69,3,487,335,600,0,265,335,600,0,0,331,2,2,335,0,1815,1908,True,232,99,sebsi:1  marzouki:0  
1,7,5,69,2,487,362,600,1,237,362,600,0,0,359,2,1,362,0,1830,1930,True,273,86,sebsi:1  marzouki:1  
1,7,5,69,1,487,357,592,3,232,357,592,0,0,344,4,9,357,0,1830,1925,True,273,71,sebsi:1  marzouki:1  
1,7,4,68,9,598,330,702,1,371,330,702,0,0,317,5,8,330,0,1850,1940,True,167,150,sebsi:1  marzouki:1  
1,7,4,68,8,598,327,700,0,373,327,700,0,0,314,9,4,327,0,0,1919,True,182,132,sebsi:1  marzouki:1  
1,7,4,68,7,598,369,700,0,331,369,700,0,0,358,3,8,369,0,1800,1900,True,185,173,sebsi:1  marzouki:1  
1,7,4,68,6,598,406,700,0,294,406,700,0,0,388,11,7,406,0,1815,,True,240,148,sebsi:1  marzouki:1  
1,7,4,68,5,598,425,700,1,274,425,700,0,0,417,6,2,425,0,1840,1956,True,306,111,sebsi:1  marzouki:1  
1,7,4,68,4,598,444,712,0,268,444,712,0,0,433,7,4,444,0,1815,1915,True,284,149,sebsi:1  marzouki:1  
1,7,4,68,3,598,462,700,0,238,462,700,0,0,451,6,5,462,0,1822,1935,True,332,119,sebsi:1  marzouki:1  
1,7,4,68,2,598,466,728,3,259,466,728,0,0,455,7,4,466,0,1830,1925,True,359,96,sebsi:1  marzouki:1  
1,7,4,68,1,598,495,700,3,202,495,700,0,0,483,11,1,495,0,1830,1930,True,406,77,sebsi:1  marzouki:1  
1,7,3,67,3,563,367,600,0,233,367,600,0,0,356,5,6,367,0,1830,1935,True,226,130,sebsi:1  marzouki:1  
1,7,1,64,4,507,258,600,1,341,258,600,0,0,252,4,2,258,0,1835,1917,True,136,116,sebsi:1  marzouki:1  
1,7,1,64,3,507,335,600,0,265,335,600,0,0,324,6,5,335,0,1835,1937,True,223,101,sebsi:1  marzouki:1  
1,7,1,64,2,507,357,600,2,241,357,600,0,0,349,1,7,357,0,1827,1928,True,258,91,sebsi:1  marzouki:1  
1,7,1,64,1,507,394,592,2,196,394,592,0,0,389,3,2,394,0,1830,1926,True,310,79,sebsi:1  marzouki:1  
1,7,1,63,6,524,219,600,0,381,219,600,0,0,215,4,0,219,0,1815,1900,True,111,104,sebsi:1  marzouki:1  
1,7,1,63,5,525,265,600,0,335,265,600,0,0,260,2,3,265,0,1820,1900,True,136,124,sebsi:1  marzouki:1  
1,7,1,63,4,525,318,600,0,282,318,600,0,0,307,7,4,318,0,1810,2000,True,181,126,sebsi:1  marzouki:1  
1,7,1,63,3,525,336,600,0,264,336,600,0,0,330,3,3,336,0,1805,,True,239,91,sebsi:1  marzouki:1  
1,7,1,63,2,525,365,601,0,237,364,601,0,1,355,7,2,364,0,1835,1945,True,269,86,sebsi:1  marzouki:1  
1,7,1,63,1,525,380,600,0,220,380,600,0,0,376,2,2,380,0,1820,2000,True,292,84,sebsi:1  marzouki:1  
