circonscriptionId,delegationId,subDelegationId,centerID,stationId,registeredVoters,aSigningVoters,bDeliveredBallots,cSpoiledBallots,dLeftBallots,fExtractedBallots,gEplusF,hBminusG,iAminusF,jListVotes,kCancelledVotes,lBlankVotes,mJplusKplusL,nFminusM,countingStart,countingEnd,tampon,sebsi,marzouki,observers
13,1,7,12,1,580,302,700,1,397,302,700,0,0,289,10,3,302,0,1815,1920,True,216,73,sebsi:1  marzouki:1  
13,1,7,11,1,532,238,600,0,362,238,600,0,0,232,5,1,238,0,1805,1840,True,170,62,sebsi:1  marzouki:1  
13,1,6,10,2,389,278,502,0,224,278,502,0,0,275,1,2,278,0,1815,1858,True,127,148,sebsi:1  marzouki:1  
13,1,6,10,1,399,298,501,0,203,298,501,0,0,290,8,0,298,0,1813,1916,True,154,136,sebsi:1  marzouki:1  
13,1,5,9,2,343,180,400,0,220,180,400,0,0,179,0,1,180,0,1815,1840,True,110,69,sebsi:1  marzouki:1  
13,1,5,9,1,344,230,400,0,170,230,400,0,0,225,3,2,230,0,1810,1840,True,171,54,sebsi:1  marzouki:1  
13,1,4,8,3,433,265,500,0,235,265,500,0,0,261,2,2,265,0,1835,1951,True,172,89,sebsi:1  marzouki:1  
13,1,4,8,1,435,323,501,0,178,323,501,1,0,313,4,6,323,0,1815,1914,True,251,62,sebsi:1  marzouki:1  
13,1,3,7,4,544,330,600,0,270,330,600,0,0,321,5,4,330,0,1810,1910,True,171,150,sebsi:1  marzouki:1  
13,1,3,7,3,546,300,600,0,300,300,600,0,0,294,3,3,300,0,,1900,True,169,125,sebsi:1  marzouki:1  
13,1,3,7,2,546,373,600,0,223,373,596,4,0,365,5,3,373,0,1800,1900,True,256,109,sebsi:1  marzouki:1  
13,1,3,7,1,546,393,584,0,191,393,584,0,0,378,3,12,393,0,115,1946,True,275,103,sebsi:1  marzouki:1  
13,1,3,6,4,558,368,600,0,232,368,600,0,0,358,9,1,368,0,1830,1920,True,145,213,sebsi:1  marzouki:1  
13,1,3,6,3,558,378,600,0,222,378,600,0,0,374,3,1,378,0,1830,1920,True,152,222,sebsi:1  marzouki:1  
13,1,3,6,2,558,439,600,1,160,439,600,0,0,433,4,2,439,0,1830,2000,True,181,252,sebsi:1  marzouki:1  
13,1,3,6,1,558,430,600,0,170,430,600,0,0,425,2,3,430,0,1830,1923,True,215,210,sebsi:1  marzouki:1  
13,1,2,5,2,319,134,400,0,264,134,398,2,0,132,2,0,134,0,1815,1840,True,75,57,sebsi:1  marzouki:1  
13,1,2,5,1,320,169,400,1,231,168,400,0,1,163,2,3,168,0,1825,1853,True,132,31,sebsi:1  marzouki:1  
13,1,2,4,1,248,112,300,0,188,112,300,0,0,108,3,1,112,0,1800,1840,True,76,32,sebsi:1  marzouki:1  
13,1,1,3,1,505,229,600,0,371,229,600,0,0,222,6,1,229,0,1815,1930,True,179,43,sebsi:1  marzouki:1  
13,1,1,2,1,499,276,600,0,324,276,600,0,0,269,6,1,276,0,1805,1905,True,225,44,sebsi:1  marzouki:1  
13,1,1,1,1,426,195,500,0,305,195,500,0,0,191,3,1,195,0,1810,1850,True,145,46,sebsi:1  marzouki:1  
13,5,8,98,1,475,285,600,0,315,285,600,0,0,278,3,4,285,0,1830,1945,True,183,95,sebsi:1  marzouki:1  
13,5,8,97,1,573,321,700,1,378,321,700,0,0,312,0,9,321,0,1816,1852,True,241,71,sebsi:1  marzouki:1  
13,5,7,95,1,126,63,200,0,137,63,200,0,0,58,4,1,63,0,1830,1930,False,39,19,sebsi:1  marzouki:1  
13,5,7,94,1,439,270,502,0,232,270,502,0,0,268,2,0,270,0,1815,1910,True,138,130,sebsi:1  marzouki:1  
13,5,6,93,2,342,150,400,0,250,150,400,0,0,148,1,1,150,0,1808,1840,True,97,51,sebsi:1  marzouki:1  
13,5,6,93,1,342,207,400,0,193,207,400,0,0,204,1,2,207,0,1806,1845,True,157,47,sebsi:1  marzouki:1  
13,5,6,92,1,577,312,700,0,388,312,700,0,0,301,5,6,312,0,1800,1910,True,239,62,sebsi:1  marzouki:1  
13,5,5,91,1,217,100,300,0,200,100,300,0,0,97,2,1,100,0,1805,1900,True,63,34,sebsi:1  marzouki:1  
13,5,5,90,1,96,53,200,0,147,53,200,0,0,51,2,0,53,0,1815,1840,False,23,28,sebsi:1  marzouki:1  
13,5,5,89,1,47,32,100,0,68,32,100,0,0,32,0,0,32,0,1815,1845,True,25,7,sebsi:1  marzouki:1  
13,5,5,88,1,293,136,400,0,264,136,400,0,0,129,7,0,136,0,1815,1830,True,43,86,sebsi:1  marzouki:1  
13,5,4,87,1,409,257,504,0,247,257,504,0,0,249,5,3,257,0,1815,,True,137,112,sebsi:1  marzouki:1  
13,5,4,86,3,598,295,700,0,405,295,700,0,0,286,4,5,295,0,1815,1900,True,185,101,sebsi:1  marzouki:1  
13,5,4,86,2,600,348,700,0,352,348,700,0,0,344,4,0,348,0,1805,1840,True,211,133,sebsi:1  marzouki:1  
13,5,4,86,1,600,419,700,0,281,419,700,0,0,408,7,4,419,0,1815,1845,True,304,104,sebsi:1  marzouki:1  
13,5,3,85,1,38,19,100,0,81,19,100,0,0,18,0,1,19,0,1800,1815,True,16,2,sebsi:1  marzouki:1  
13,5,3,84,3,519,287,600,0,313,287,600,0,0,279,7,1,287,0,1810,1905,True,215,64,sebsi:1  marzouki:1  
13,5,3,84,2,519,372,600,0,228,372,600,0,0,362,6,4,372,0,1815,1905,True,297,65,sebsi:1  marzouki:1  
13,5,3,84,1,519,367,600,0,233,367,600,0,0,358,6,3,367,0,1805,1910,True,311,47,sebsi:1  marzouki:1  
13,5,2,83,1,512,328,600,1,271,328,600,0,0,321,0,7,328,0,1825,1920,True,248,73,sebsi:1  marzouki:1  
13,5,2,82,4,519,324,600,1,275,324,600,0,0,319,5,0,324,0,1820,1920,True,204,115,sebsi:1  marzouki:1  
13,5,2,82,3,519,282,600,0,318,282,600,0,0,282,0,0,282,0,1815,1850,True,190,92,sebsi:1  marzouki:1  
13,5,2,82,1,519,376,598,0,222,376,598,0,0,360,7,9,376,0,,1915,True,264,96,sebsi:1  marzouki:1  
13,5,2,81,2,437,234,500,0,266,234,500,0,0,225,4,5,234,0,1810,1844,True,150,75,sebsi:1  marzouki:1  
13,5,2,81,1,437,319,500,0,181,319,500,0,0,309,6,4,319,0,1815,1856,True,246,63,sebsi:1  marzouki:1  
13,5,2,80,4,500,312,600,1,287,312,600,0,0,302,5,5,312,0,1830,1915,True,204,98,sebsi:1  marzouki:1  
13,5,2,80,3,502,320,600,0,280,320,600,0,0,312,4,4,320,0,1830,1920,True,221,91,sebsi:1  marzouki:1  
13,5,2,80,2,502,381,600,0,219,381,600,0,0,378,0,3,381,0,1830,1921,True,279,99,sebsi:1  marzouki:1  
13,5,2,80,1,502,384,600,0,216,384,600,0,0,381,1,2,384,0,1830,1930,True,300,81,sebsi:1  marzouki:1  
13,5,1,79,3,523,342,600,0,258,342,600,0,0,330,9,3,342,0,1815,1930,True,175,155,sebsi:1  marzouki:1  
13,5,1,79,2,524,348,609,0,261,348,609,0,0,343,2,3,348,0,1830,1930,True,177,166,sebsi:1  marzouki:1  
13,5,1,79,1,524,396,600,0,204,396,600,0,0,380,12,4,396,0,1818,1944,True,224,156,sebsi:1  marzouki:1  
13,5,1,78,7,558,325,600,0,275,325,600,0,0,315,5,5,325,0,1820,1915,True,191,124,sebsi:1  marzouki:1  
13,5,1,78,5,563,355,600,0,245,355,600,0,0,344,4,7,355,0,1815,1930,True,232,112,sebsi:1  marzouki:1  
13,5,1,78,4,563,373,600,0,227,373,600,0,0,368,5,0,373,0,1822,1909,True,247,121,sebsi:1  marzouki:1  
13,5,1,78,3,563,425,600,1,174,425,600,0,0,417,5,3,425,0,1815,1915,True,286,131,sebsi:1  marzouki:1  
13,5,1,78,2,563,452,600,0,148,452,600,0,0,441,8,3,452,0,1821,2010,True,319,122,sebsi:1  marzouki:1  
13,5,1,78,1,563,436,600,0,164,436,600,0,0,426,6,4,436,0,1810,1930,True,332,94,sebsi:1  marzouki:1  
13,6,5,109,1,512,273,600,0,327,273,600,0,0,267,2,4,273,0,1800,1835,True,205,62,sebsi:1  marzouki:1  
13,6,4,108,2,355,132,396,0,264,132,396,0,0,129,2,1,132,0,1805,1856,True,63,66,sebsi:1  marzouki:1  
13,6,4,108,1,355,219,400,0,181,219,400,0,0,212,5,2,219,0,1810,1835,True,147,65,sebsi:1  marzouki:1  
13,6,4,107,2,333,162,400,0,238,162,400,0,0,154,8,0,162,0,1815,1843,True,81,73,sebsi:1  marzouki:1  
13,6,4,107,1,334,212,400,0,188,212,400,0,0,209,2,1,212,0,1830,1850,True,142,67,sebsi:1  marzouki:1  
13,6,4,106,2,495,182,605,0,423,182,605,0,0,173,6,3,182,0,1808,1850,True,117,56,sebsi:1  marzouki:1  
13,6,4,106,1,495,279,600,0,321,279,600,0,0,266,7,6,279,0,1815,1905,True,188,78,sebsi:1  marzouki:1  
13,6,3,105,1,276,113,300,0,187,113,300,0,0,112,1,0,113,0,1812,1844,True,85,27,sebsi:1  marzouki:1  
13,6,3,104,2,327,144,400,0,256,144,400,0,0,139,1,4,144,0,1805,1855,True,87,52,sebsi:1  marzouki:1  
13,6,3,104,1,328,202,400,0,198,202,400,0,0,192,10,0,202,0,1815,1850,True,149,43,sebsi:1  marzouki:1  
13,6,2,103,1,401,246,500,0,254,246,500,0,0,234,12,0,246,0,1810,1842,True,156,78,sebsi:1  marzouki:1  
13,6,2,102,2,508,301,600,0,299,301,600,0,0,296,3,2,301,0,1815,1915,True,167,129,sebsi:1  marzouki:1  
13,6,2,102,1,508,359,600,0,241,359,600,0,0,345,8,6,359,0,1805,1905,True,242,103,sebsi:1  marzouki:1  
13,6,1,101,1,146,83,200,1,117,82,200,100,1,76,6,0,82,1,1805,1835,True,51,25,sebsi:1  marzouki:1  
13,6,1,100,1,371,181,400,0,219,181,400,0,0,165,14,2,181,0,1810,1845,True,81,84,sebsi:1  marzouki:1  
13,6,1,99,1,561,310,600,0,290,310,600,0,0,298,11,1,310,0,1800,1850,True,168,130,sebsi:1  marzouki:1  
13,3,5,64,2,438,110,500,0,390,110,500,0,0,106,2,2,110,0,1810,1841,True,49,57,sebsi:1  marzouki:1  
13,3,5,64,1,438,223,500,0,277,223,500,0,0,220,2,1,223,0,1800,1900,True,127,93,sebsi:1  marzouki:1  
13,3,5,63,1,232,94,300,0,206,94,300,0,0,92,2,0,94,0,1820,,True,64,28,sebsi:1  marzouki:1  
13,3,5,62,1,474,249,500,0,251,249,500,0,0,245,2,2,249,0,1815,1840,True,170,75,sebsi:1  marzouki:1  
13,3,5,61,1,547,288,600,0,312,288,600,0,0,282,3,3,288,0,,,True,133,149,sebsi:1  marzouki:1  
13,3,4,60,1,495,266,600,0,334,266,600,0,0,258,7,1,266,0,1830,1900,True,134,124,sebsi:1  marzouki:1  
13,3,4,59,1,448,152,500,0,348,152,500,0,0,143,6,3,152,0,1816,1845,True,80,63,sebsi:1  marzouki:1  
13,3,4,58,1,536,262,600,1,337,262,600,0,0,252,8,2,262,0,,1840,True,73,179,sebsi:1  marzouki:1  
13,3,4,57,1,549,291,600,0,309,291,600,0,0,286,4,1,291,0,1810,1841,True,160,126,sebsi:1  marzouki:1  
13,3,4,56,2,452,146,500,0,354,146,500,0,0,145,1,0,146,0,1815,1840,True,64,81,sebsi:1  marzouki:1  
13,3,4,56,1,452,256,500,0,244,256,500,0,0,250,3,3,256,0,1814,1850,True,119,131,sebsi:1  marzouki:1  
13,3,3,55,1,166,73,200,0,127,73,200,0,0,68,4,1,73,0,1815,1850,True,50,18,sebsi:1  marzouki:1  
13,3,3,54,1,323,196,400,0,204,196,400,0,0,189,5,2,196,0,1800,1830,False,76,113,sebsi:1  marzouki:1  
13,3,3,53,1,329,125,400,0,275,125,400,0,0,118,4,3,125,0,1815,1900,True,76,42,sebsi:1  marzouki:1  
13,3,2,52,2,374,158,400,0,242,158,400,0,0,154,1,3,158,0,1815,1850,True,59,95,sebsi:1  marzouki:1  
13,3,2,52,1,374,248,500,0,252,248,500,0,0,236,2,10,248,0,1805,1855,True,115,121,sebsi:1  marzouki:1  
13,3,2,51,1,524,285,600,0,315,285,600,0,0,283,2,0,285,0,1802,1850,True,189,94,sebsi:1  marzouki:1  
13,3,2,50,2,313,130,400,0,270,130,400,0,0,126,2,2,130,0,1810,1900,True,46,80,sebsi:1  marzouki:1  
13,3,2,50,1,314,179,400,0,221,179,400,0,0,168,3,8,179,0,1900,2000,True,114,54,sebsi:1  marzouki:1  
13,3,2,49,2,525,200,600,0,400,200,600,0,0,196,4,0,200,0,1800,1830,True,70,126,sebsi:1  marzouki:1  
13,3,2,49,1,526,365,598,0,233,365,598,0,0,360,4,1,365,0,1800,1846,False,177,183,sebsi:1  marzouki:1  
13,3,1,48,1,416,214,500,0,286,214,500,0,0,212,1,1,214,0,1801,1852,True,91,121,sebsi:1  marzouki:1  
13,3,1,47,2,301,102,400,0,298,102,400,0,0,98,3,1,102,0,1820,1900,True,45,53,sebsi:1  marzouki:1  
13,3,1,47,1,301,178,400,0,222,178,400,0,0,174,3,1,178,0,1820,1842,True,102,72,sebsi:1  marzouki:1  
13,3,1,46,3,473,240,498,0,258,240,498,0,0,236,0,4,240,0,1810,1845,True,141,95,sebsi:1  marzouki:1  
13,3,1,46,2,475,291,500,0,210,290,500,0,1,285,1,4,290,0,1810,1900,True,164,121,sebsi:1  marzouki:1  
13,3,1,46,1,475,351,496,0,145,351,496,0,0,343,5,3,351,0,,1905,True,243,100,sebsi:1  marzouki:1  
13,3,1,45,1,465,302,500,0,198,302,500,0,0,272,28,2,302,0,1820,1910,True,73,199,sebsi:1  marzouki:1  
13,3,1,44,4,592,317,700,0,383,317,700,0,0,307,8,2,317,0,1810,1915,True,129,178,sebsi:1  marzouki:1  
13,3,1,44,3,594,307,700,0,393,307,700,0,0,299,0,8,307,0,1800,1920,True,144,155,sebsi:1  marzouki:1  
13,3,1,44,1,594,439,700,0,266,439,705,5,0,422,16,1,439,0,1805,1920,True,304,118,sebsi:1  marzouki:1  
13,2,13,43,1,191,89,300,0,211,89,300,0,0,86,3,0,89,0,1800,1830,True,51,35,sebsi:1  marzouki:1  
13,2,13,42,2,314,119,400,0,281,119,400,0,0,116,2,1,119,0,1810,1845,True,77,39,sebsi:1  marzouki:1  
13,2,13,42,1,315,199,400,0,201,199,400,0,0,194,2,3,199,0,1805,1845,True,154,40,sebsi:1  marzouki:1  
13,2,12,41,1,227,103,300,0,197,103,300,0,0,100,3,0,103,0,1825,1840,True,69,31,sebsi:1  marzouki:1  
13,2,12,40,1,155,79,201,0,122,79,201,0,0,79,0,0,79,0,1800,1842,True,64,15,sebsi:1  marzouki:1  
13,2,12,39,1,169,89,200,0,111,89,200,0,0,84,2,3,89,0,1805,1825,True,62,22,sebsi:1  marzouki:1  
13,2,11,38,2,330,98,400,0,302,98,400,0,0,95,1,2,98,0,1810,1825,True,70,25,sebsi:1  marzouki:1  
13,2,11,38,1,331,162,400,0,238,162,400,0,0,162,0,0,162,0,1810,1845,True,123,39,sebsi:1  marzouki:1  
13,2,10,37,1,301,138,401,0,263,138,401,0,0,135,1,2,138,0,1805,1840,True,84,51,sebsi:1  marzouki:1  
13,2,10,36,1,241,113,300,0,187,113,300,0,0,112,0,1,113,0,1807,1832,True,76,36,sebsi:1  marzouki:1  
13,2,10,35,2,346,165,400,1,234,165,400,0,0,164,1,0,165,0,1810,1845,True,97,67,sebsi:1  marzouki:1  
13,2,10,35,1,346,212,400,0,188,212,400,0,0,205,5,2,212,0,1810,1836,True,141,64,sebsi:1  marzouki:1  
13,2,10,34,2,470,187,500,0,313,187,500,0,0,186,0,1,187,0,1830,1856,True,87,99,sebsi:1  marzouki:1  
13,2,10,34,1,470,324,500,0,176,324,500,0,0,311,6,7,324,0,1812,,True,213,98,sebsi:1  marzouki:1  
13,2,9,33,1,371,199,400,0,201,199,400,0,0,194,1,4,199,0,1819,1908,True,121,73,sebsi:1  marzouki:1  
13,2,8,32,1,419,211,500,0,289,211,500,0,0,208,2,1,211,0,1815,1850,True,172,36,sebsi:1  marzouki:1  
13,2,8,31,1,472,269,500,0,231,269,500,0,0,256,11,2,269,0,1810,1920,True,156,100,sebsi:1  marzouki:1  
13,2,7,30,1,224,131,300,0,169,131,300,0,0,129,0,2,131,0,1810,1840,True,86,43,sebsi:1  marzouki:1  
13,2,7,29,1,352,135,400,0,265,135,400,0,0,130,2,3,135,0,1800,1900,True,99,31,sebsi:1  marzouki:1  
13,2,7,28,1,600,185,600,0,415,185,600,0,0,183,0,2,185,0,1815,1900,True,132,51,sebsi:1  marzouki:1  
13,2,6,27,1,97,52,200,0,148,52,200,0,0,49,2,1,52,0,,1826,False,30,19,sebsi:1  marzouki:1  
13,2,6,26,1,114,73,200,0,127,73,200,0,0,72,1,0,73,0,1810,1845,True,55,17,sebsi:1  marzouki:1  
13,2,6,25,1,270,141,300,0,159,141,300,0,0,137,4,0,141,0,1805,1900,True,107,30,sebsi:1  marzouki:1  
13,2,6,24,1,102,55,200,0,145,55,200,0,0,50,3,2,55,0,1805,1825,True,38,12,sebsi:1  marzouki:1  
13,2,6,23,1,531,280,600,0,320,280,600,0,0,275,2,3,280,0,1815,1910,True,203,72,sebsi:1  marzouki:1  
13,2,5,22,2,520,265,598,1,332,265,598,0,0,259,4,2,265,0,1820,1920,True,151,108,sebsi:1  marzouki:1  
13,2,5,22,1,520,349,597,1,247,349,597,0,0,343,2,4,349,0,1847,1928,True,243,100,sebsi:1  marzouki:1  
13,2,5,21,6,592,352,696,0,344,352,696,0,0,341,8,3,352,0,1835,1930,True,174,167,sebsi:1  marzouki:1  
13,2,5,21,5,596,299,700,0,401,299,700,0,0,289,5,5,299,0,1825,1915,True,173,116,sebsi:1  marzouki:1  
13,2,5,21,4,596,301,696,0,395,301,696,0,0,299,1,1,301,0,1830,1930,True,180,119,sebsi:1  marzouki:1  
13,2,5,21,3,596,379,700,0,321,379,700,0,0,375,4,0,379,0,1830,1930,True,230,145,sebsi:1  marzouki:1  
13,2,5,21,2,596,424,700,0,276,424,700,0,0,409,6,9,424,0,1830,1945,True,249,160,sebsi:1  marzouki:1  
13,2,5,21,1,596,455,700,0,245,455,700,0,0,446,6,3,455,0,1830,2000,True,323,123,sebsi:1  marzouki:1  
13,2,5,20,5,562,316,600,0,284,316,600,0,0,304,10,2,316,0,1830,1907,True,207,97,sebsi:1  marzouki:1  
13,2,5,20,4,566,290,603,0,313,290,603,0,0,281,6,3,290,0,1830,1915,True,175,106,sebsi:1  marzouki:1  
13,2,5,20,3,566,366,600,0,234,366,600,0,0,358,4,4,366,0,1830,1945,True,241,117,sebsi:1  marzouki:1  
13,2,5,20,2,566,396,600,0,204,396,600,0,0,380,6,10,396,0,1830,1945,True,258,122,sebsi:1  marzouki:1  
13,2,5,20,1,566,393,600,1,205,393,600,0,0,384,4,5,393,0,1830,2000,True,292,92,sebsi:1  marzouki:1  
13,2,4,19,1,185,80,200,0,120,80,200,0,0,78,1,1,80,0,1800,1820,True,34,44,sebsi:1  marzouki:1  
13,2,3,18,1,378,171,400,0,229,171,400,0,0,169,1,1,171,0,1810,1835,True,133,36,sebsi:1  marzouki:1  
13,2,3,17,1,336,209,400,0,191,209,400,0,0,202,5,2,209,0,1810,1845,True,175,27,sebsi:1  marzouki:1  
13,2,3,16,1,260,111,300,0,189,111,300,0,0,111,0,0,111,0,1815,1840,True,100,11,sebsi:1  marzouki:1  
13,2,2,15,1,461,182,500,0,318,182,500,0,0,180,1,1,182,0,1815,1900,True,146,34,sebsi:1  marzouki:1  
13,2,1,14,4,532,302,600,0,298,302,600,0,0,290,5,7,302,0,1818,1903,True,175,115,sebsi:1  marzouki:1  
13,2,1,14,3,535,294,600,0,306,294,600,0,0,289,4,1,294,0,1820,1905,True,191,98,sebsi:1  marzouki:1  
13,2,1,14,2,535,390,600,0,210,390,600,0,0,386,2,2,390,0,1830,1930,True,243,143,sebsi:1  marzouki:1  
13,2,1,13,3,540,263,602,1,338,263,602,0,0,253,7,3,263,0,1840,1915,True,163,90,sebsi:1  marzouki:1  
13,2,1,13,2,540,311,600,0,289,311,600,0,0,302,6,3,311,0,1830,1935,True,183,119,sebsi:1  marzouki:1  
13,2,1,13,1,540,371,596,0,225,371,596,0,0,354,13,4,371,0,1815,1945,True,255,99,sebsi:1  marzouki:1  
13,4,8,77,1,563,327,600,0,273,327,600,0,0,319,5,3,327,0,1820,1920,True,226,93,sebsi:1  marzouki:1  
13,4,8,76,1,215,145,300,0,155,145,300,0,0,140,5,0,145,0,1815,1840,True,108,32,sebsi:1  marzouki:1  
13,4,7,75,1,318,171,400,0,229,171,400,0,0,168,3,0,171,0,1810,1845,True,62,106,sebsi:1  marzouki:1  
13,4,6,74,1,163,100,202,0,102,100,202,0,0,98,2,0,100,0,1808,1826,True,52,46,sebsi:1  marzouki:1  
13,4,6,73,1,306,116,400,0,284,116,400,0,0,109,4,3,116,0,1815,1835,True,45,64,sebsi:1  marzouki:1  
13,4,5,72,4,568,284,600,0,316,284,600,0,0,276,5,3,284,0,1830,1930,True,111,165,sebsi:1  marzouki:1  
13,4,5,72,3,570,300,600,2,298,300,600,0,0,295,4,1,300,0,1800,1915,True,100,195,sebsi:1  marzouki:1  
13,4,5,72,2,570,348,600,0,252,348,600,0,0,340,7,1,348,0,1830,1910,True,150,190,sebsi:1  marzouki:1  
13,4,5,72,1,570,368,600,1,231,368,600,0,0,348,8,12,368,0,1830,1945,True,225,123,sebsi:1  marzouki:1  
13,4,4,71,1,502,262,600,1,337,262,600,0,0,252,4,6,262,0,1830,1925,True,150,102,sebsi:1  marzouki:1  
13,4,4,70,2,455,193,500,1,306,193,500,0,0,186,4,3,193,0,1815,1900,True,131,55,sebsi:1  marzouki:1  
13,4,4,70,1,456,319,500,0,181,319,500,0,0,310,4,5,319,0,1830,1917,True,238,72,sebsi:1  marzouki:1  
13,4,3,69,1,142,81,200,0,119,81,200,0,0,78,3,0,81,0,1810,1825,True,21,57,sebsi:1  marzouki:1  
13,4,3,68,1,296,140,400,0,260,140,400,0,0,135,5,0,140,0,1800,1825,True,78,57,sebsi:1  marzouki:1  
13,4,2,67,2,549,262,600,1,337,262,600,0,0,253,5,4,262,0,1810,1853,True,111,142,sebsi:1  marzouki:1  
13,4,2,67,1,550,329,600,0,271,329,600,0,0,322,3,4,329,0,1815,1840,True,140,182,sebsi:1  marzouki:1  
13,4,1,66,3,449,240,500,0,260,240,500,0,0,233,5,2,240,0,1807,1900,True,87,146,sebsi:1  marzouki:1  
13,4,1,66,2,450,268,500,1,227,268,496,4,0,260,6,2,268,0,,1900,True,92,168,sebsi:1  marzouki:1  
13,4,1,66,1,450,307,500,0,193,307,500,0,0,301,5,1,307,0,1815,1856,True,138,163,sebsi:1  marzouki:1  
13,4,1,65,3,589,346,700,0,354,346,700,0,0,342,0,4,346,0,1815,1926,True,119,223,sebsi:1  marzouki:1  
13,4,1,65,2,589,369,687,0,318,369,687,0,0,366,1,2,369,0,1815,1915,True,135,231,sebsi:1  marzouki:1  
