circonscriptionId,delegationId,subDelegationId,centerID,stationId,registeredVoters,aSigningVoters,bDeliveredBallots,cSpoiledBallots,dLeftBallots,fExtractedBallots,gEplusF,hBminusG,iAminusF,jListVotes,kCancelledVotes,lBlankVotes,mJplusKplusL,nFminusM,countingStart,countingEnd,tampon,sebsi,marzouki,observers
16,8,7,206,3,466,107,500,0,393,107,500,0,0,106,0,1,107,0,1812,1830,True,58,48,sebsi:  marzouki:  
16,8,7,206,2,467,163,500,0,337,163,500,0,0,159,3,1,163,0,1820,1856,True,100,59,sebsi:  marzouki:  
16,8,7,206,1,467,273,500,2,225,273,500,0,0,262,10,1,273,0,1815,1855,False,196,66,sebsi:  marzouki:  
16,8,6,205,2,331,113,400,0,287,113,400,0,0,107,5,1,113,0,1815,1845,True,53,54,sebsi:  marzouki:  
16,8,6,205,1,331,184,400,0,216,184,400,0,0,180,3,1,184,0,1820,1905,True,122,58,sebsi:  marzouki:  
16,8,6,204,1,499,243,600,0,357,243,600,0,0,236,6,1,243,0,1805,,True,200,36,sebsi:  marzouki:  
16,8,6,203,2,417,159,497,0,338,159,497,0,0,156,3,0,159,0,1810,1850,True,82,74,sebsi:1  marzouki:0  
16,8,6,203,1,417,251,500,1,248,251,500,0,0,242,6,3,251,0,1800,1900,True,165,77,sebsi:1  marzouki:1  
16,8,5,202,1,130,58,200,1,142,57,200,0,1,53,2,2,57,0,1800,1830,True,11,42,sebsi:1  marzouki:0  
16,8,5,201,1,346,146,400,0,254,146,400,0,0,144,2,0,146,0,1809,1835,True,85,59,sebsi:1  marzouki:1  
16,8,5,200,1,314,157,400,0,243,157,400,0,0,154,0,3,157,0,1805,1850,True,38,116,sebsi:1  marzouki:0  
16,8,5,199,1,274,108,300,0,192,108,300,0,0,107,0,1,108,0,1826,1849,True,64,43,sebsi:1  marzouki:1  
16,8,5,198,1,304,93,400,0,307,93,400,0,0,89,3,1,93,0,1800,1900,True,57,32,sebsi:1  marzouki:1  
16,8,5,197,2,307,118,400,0,282,118,400,0,0,112,3,3,118,0,1815,1900,True,54,58,sebsi:1  marzouki:1  
16,8,5,197,1,308,154,400,0,246,154,400,0,0,150,2,2,154,0,1800,1830,True,77,73,sebsi:1  marzouki:1  
16,8,4,195,2,519,130,600,0,470,130,600,0,0,127,3,0,130,0,1800,1900,True,95,32,sebsi:1  marzouki:1  
16,8,4,195,1,520,238,600,0,362,238,600,0,0,233,3,2,238,0,1830,1920,True,206,27,sebsi:1  marzouki:1  
16,8,3,194,2,511,158,600,0,442,158,600,0,0,155,3,0,158,0,1845,1930,True,72,83,sebsi:1  marzouki:0  
16,8,3,194,1,512,219,600,0,381,219,600,0,0,214,4,1,219,0,1820,1905,True,137,77,sebsi:1  marzouki:1  
16,8,2,193,1,450,137,500,1,362,137,500,0,0,135,2,0,137,0,1830,1905,True,110,25,sebsi:1  marzouki:1  
16,8,2,192,1,214,80,300,0,220,80,300,0,0,77,1,2,80,0,1800,1825,True,63,14,sebsi:1  marzouki:1  
16,8,2,191,1,385,130,500,0,370,130,500,0,0,123,5,2,130,0,1800,1833,True,106,17,sebsi:1  marzouki:1  
16,8,1,190,1,505,165,600,0,435,165,600,0,0,157,7,1,165,0,1815,1830,True,91,66,sebsi:1  marzouki:1  
16,8,1,189,1,272,86,303,0,217,86,303,0,0,83,2,1,86,0,1800,1817,True,62,21,sebsi:1  marzouki:0  
16,8,1,188,2,542,199,600,0,401,199,600,0,0,189,8,2,199,0,1815,1835,True,116,73,sebsi:1  marzouki:1  
16,8,1,188,1,543,317,599,0,282,317,599,0,0,309,3,5,317,0,1814,1900,True,238,71,sebsi:1  marzouki:1  
16,10,11,270,2,490,246,602,0,356,246,602,0,0,240,5,1,246,0,1800,1915,True,121,119,sebsi:1  marzouki:1  
16,10,11,270,1,491,350,600,2,248,350,600,0,0,333,14,3,350,0,1809,1910,True,244,89,sebsi:1  marzouki:1  
16,10,11,269,4,555,206,600,0,394,206,600,0,0,199,6,1,206,0,1815,1900,True,109,90,sebsi:1  marzouki:1  
16,10,11,269,3,558,248,600,2,350,248,600,0,0,242,1,5,248,0,1838,1915,True,130,112,sebsi:1  marzouki:0  
16,10,11,269,2,558,358,600,2,240,358,600,0,0,349,5,4,358,0,1815,1923,True,234,115,sebsi:1  marzouki:1  
16,10,11,269,1,558,360,600,0,240,360,600,0,0,358,2,0,360,0,1825,1910,True,273,85,sebsi:1  marzouki:0  
16,10,10,268,1,506,233,600,1,366,233,600,0,0,227,3,3,233,0,1800,1833,True,175,52,sebsi:1  marzouki:1  
16,10,9,267,2,352,108,400,0,292,108,400,0,0,104,4,0,108,0,1800,1825,True,59,45,sebsi:1  marzouki:0  
16,10,9,267,1,352,170,400,0,230,170,400,0,0,169,0,1,170,0,1800,1840,True,110,59,sebsi:1  marzouki:0  
16,10,9,266,1,590,284,700,0,416,284,700,0,0,268,15,1,284,0,1815,1855,True,164,104,sebsi:1  marzouki:1  
16,10,9,265,2,357,150,400,0,250,150,400,0,0,147,0,3,150,0,1810,1830,True,62,85,sebsi:1  marzouki:1  
16,10,9,265,1,357,227,400,0,173,227,400,0,0,223,4,0,227,0,1804,1845,True,127,96,sebsi:1  marzouki:1  
16,10,9,264,2,398,133,500,0,367,133,500,0,0,132,1,0,133,0,1800,1835,True,59,73,sebsi:0  marzouki:1  
16,10,9,264,1,398,217,500,0,283,217,500,0,0,215,2,0,217,0,1815,1906,True,123,92,sebsi:1  marzouki:0  
16,10,9,263,2,560,296,600,0,304,296,600,0,0,290,4,2,296,0,1815,1900,True,148,142,sebsi:1  marzouki:1  
16,10,9,263,1,560,380,608,0,228,380,608,0,0,375,2,3,380,0,1800,1905,True,212,163,sebsi:1  marzouki:1  
16,10,8,262,1,485,250,599,0,349,250,599,0,0,244,3,3,250,0,1812,1855,True,170,74,sebsi:1  marzouki:1  
16,10,8,261,2,447,106,500,0,394,106,500,0,0,102,3,1,106,0,1810,1840,True,57,45,sebsi:1  marzouki:1  
16,10,8,261,1,447,203,500,0,297,203,500,0,0,199,2,2,203,0,1800,1844,True,129,70,sebsi:1  marzouki:1  
16,10,8,260,1,455,195,500,0,305,195,500,0,0,192,2,1,195,0,,1850,True,146,46,sebsi:1  marzouki:0  
16,10,7,259,1,547,207,600,1,392,207,600,0,0,202,1,4,207,0,1830,1859,True,159,43,sebsi:1  marzouki:1  
16,10,6,258,1,266,124,300,0,176,124,300,0,0,123,1,0,124,0,1810,1833,True,86,37,sebsi:1  marzouki:0  
16,10,6,257,1,503,225,600,0,375,225,600,0,0,221,3,1,225,0,1800,1852,True,128,93,sebsi:1  marzouki:0  
16,10,5,256,1,437,141,500,0,359,141,500,0,0,136,4,1,141,0,1815,1849,True,110,26,sebsi:1  marzouki:0  
16,10,5,255,1,290,85,400,0,315,85,400,0,0,81,2,2,85,0,1810,1837,True,54,27,sebsi:1  marzouki:0  
16,10,4,254,2,344,140,400,0,260,140,400,0,0,137,2,1,140,0,1810,1845,True,68,69,sebsi:1  marzouki:1  
16,10,4,254,1,344,208,400,1,191,208,400,0,0,198,8,2,208,0,1808,1900,True,118,80,sebsi:1  marzouki:1  
16,10,4,253,2,300,63,400,0,337,63,400,0,0,62,0,1,63,0,1800,1835,True,22,40,sebsi:0  marzouki:0  
16,10,4,253,1,301,109,399,0,290,109,399,0,0,106,3,0,109,0,1810,1840,True,80,26,sebsi:1  marzouki:1  
16,10,4,252,1,384,131,500,0,369,131,500,0,0,129,2,0,131,0,1800,1828,True,97,32,sebsi:1  marzouki:0  
16,10,4,251,1,494,154,600,1,445,154,600,0,0,148,3,3,154,0,1812,1840,True,118,30,sebsi:1  marzouki:0  
16,10,4,250,1,290,120,400,0,280,120,400,0,0,120,0,0,120,0,,1840,True,62,58,sebsi:1  marzouki:0  
16,10,4,249,1,375,134,400,0,266,134,400,0,0,133,1,0,134,0,1815,1840,True,41,92,sebsi:1  marzouki:0  
16,10,3,248,2,365,109,400,0,291,109,400,0,0,106,3,0,109,0,1800,1850,True,40,66,sebsi:1  marzouki:0  
16,10,3,248,1,365,191,400,0,209,191,400,0,0,184,4,3,191,0,1810,1900,True,105,79,sebsi:1  marzouki:0  
16,10,3,247,1,364,194,404,0,210,194,404,0,0,186,6,2,194,0,1810,1900,True,164,22,sebsi:  marzouki:  
16,10,2,246,2,385,180,500,0,320,180,500,0,0,175,4,1,180,0,,1830,True,120,55,sebsi:1  marzouki:0  
16,10,2,246,1,385,253,500,0,247,253,500,0,0,246,2,5,253,0,1805,1910,True,197,49,sebsi:1  marzouki:0  
16,10,2,245,5,538,253,600,0,347,253,600,0,0,248,4,1,253,0,1800,1840,True,124,124,sebsi:  marzouki:  
16,10,2,245,4,539,226,600,0,374,226,600,0,0,222,2,2,226,0,1830,1906,True,112,110,sebsi:  marzouki:  
16,10,2,245,3,539,310,584,0,274,310,584,0,0,306,3,1,310,0,1815,1849,True,182,124,sebsi:  marzouki:  
16,10,2,245,2,539,363,600,0,237,363,600,0,0,360,2,1,363,0,1830,1940,True,246,114,sebsi:  marzouki:  
16,10,2,245,1,539,368,600,0,232,368,600,0,0,359,4,5,368,0,1810,1855,True,234,125,sebsi:  marzouki:  
16,10,2,244,4,481,201,600,0,399,201,600,0,0,196,5,0,201,0,1800,1845,True,102,94,sebsi:  marzouki:  
16,10,2,244,3,483,243,600,0,357,243,600,0,0,238,2,3,243,0,1830,1852,True,148,90,sebsi:1  marzouki:1  
16,10,2,244,2,483,307,600,0,293,307,600,0,0,301,3,3,307,0,1820,1910,True,205,96,sebsi:1  marzouki:1  
16,10,2,244,1,483,342,600,0,258,342,600,0,0,336,3,3,342,0,,1900,True,246,90,sebsi:1  marzouki:1  
16,10,2,243,5,578,245,701,0,456,245,701,0,0,237,5,3,245,0,1805,1850,True,131,106,sebsi:1  marzouki:1  
16,10,2,243,4,582,285,700,0,415,285,700,0,0,273,5,7,285,0,1800,1910,True,148,125,sebsi:1  marzouki:1  
16,10,2,243,3,582,352,700,0,348,352,700,0,0,343,6,3,352,0,1800,1900,True,209,134,sebsi:1  marzouki:1  
16,10,2,243,2,582,424,700,0,276,424,700,0,0,420,3,1,424,0,1820,1905,True,277,143,sebsi:1  marzouki:1  
16,10,2,243,1,582,422,700,0,278,422,700,0,0,403,14,5,422,0,,1850,True,319,84,sebsi:1  marzouki:1  
16,10,1,242,3,529,196,600,0,404,196,600,0,0,192,2,2,196,0,1810,1845,True,116,76,sebsi:1  marzouki:1  
16,10,1,242,2,531,260,600,0,340,260,600,0,0,255,2,3,260,0,1810,1850,True,158,97,sebsi:1  marzouki:1  
16,10,1,242,1,531,331,600,0,269,331,600,0,0,326,4,1,331,0,,1857,True,242,84,sebsi:1  marzouki:1  
16,10,1,241,4,539,249,593,0,344,249,593,0,0,244,5,0,249,0,1815,1855,True,107,137,sebsi:1  marzouki:1  
16,10,1,241,3,541,294,601,0,307,294,601,0,0,289,2,3,294,0,1800,1845,True,127,162,sebsi:1  marzouki:1  
16,10,1,241,2,541,374,599,0,225,374,599,0,0,368,5,1,374,0,1840,1925,True,190,178,sebsi:1  marzouki:1  
16,10,1,241,1,541,389,600,0,211,389,600,0,0,386,1,2,389,0,1805,1900,True,236,150,sebsi:1  marzouki:0  
16,10,1,240,5,583,270,700,0,430,270,700,0,0,254,11,5,270,0,1800,1910,True,135,119,sebsi:1  marzouki:1  
16,10,1,240,4,586,251,700,1,448,251,700,0,0,243,7,1,251,0,1820,1905,True,142,101,sebsi:1  marzouki:1  
16,10,1,240,3,586,333,700,0,367,333,700,0,0,321,11,1,333,0,1820,1915,True,210,111,sebsi:1  marzouki:1  
16,10,1,240,2,586,389,700,0,311,389,700,0,0,386,2,1,389,0,1800,1900,True,268,118,sebsi:1  marzouki:1  
16,10,1,240,1,586,411,700,0,289,411,700,0,0,393,10,8,411,0,1800,1912,True,282,111,sebsi:1  marzouki:1  
16,10,1,239,7,537,279,600,0,321,279,600,0,0,269,8,2,279,0,1801,1846,True,138,131,sebsi:1  marzouki:1  
16,10,1,239,6,538,263,600,0,337,263,600,0,0,249,13,1,263,0,1800,1910,True,113,136,sebsi:1  marzouki:1  
16,10,1,239,5,538,264,600,2,334,264,600,0,0,255,8,1,264,0,1822,1911,True,140,115,sebsi:1  marzouki:1  
16,10,1,239,4,538,323,600,1,276,323,600,0,0,314,5,4,323,0,1800,1853,True,180,134,sebsi:1  marzouki:1  
16,10,1,239,3,538,374,600,0,226,374,600,0,0,363,6,5,374,0,,1925,True,213,150,sebsi:1  marzouki:1  
16,10,1,239,2,538,378,588,0,210,378,588,0,0,373,4,1,378,0,1810,1915,True,259,114,sebsi:1  marzouki:1  
16,10,1,239,1,538,401,600,0,199,401,600,0,0,394,2,5,401,0,1810,1855,True,272,122,sebsi:1  marzouki:1  
16,9,11,238,1,273,130,301,0,171,130,301,0,0,127,2,1,130,0,1805,1825,True,97,30,sebsi:1  marzouki:0  
16,9,10,237,1,347,176,396,0,220,176,396,0,0,170,2,4,176,0,1815,1907,True,102,68,sebsi:1  marzouki:1  
16,9,10,236,1,326,149,400,2,249,149,400,0,0,149,0,0,149,0,1810,1830,True,88,61,sebsi:1  marzouki:1  
16,9,10,235,1,214,65,300,0,235,65,300,0,0,63,0,2,65,0,1815,1825,True,45,18,sebsi:0  marzouki:0  
16,9,10,234,1,243,88,300,0,212,88,300,0,0,85,2,1,88,0,1805,1845,True,69,16,sebsi:1  marzouki:0  
16,9,10,233,2,459,174,500,0,326,174,500,0,0,166,7,1,174,0,1800,1850,True,118,48,sebsi:1  marzouki:1  
16,9,10,233,1,459,273,500,1,226,273,500,0,0,267,6,0,273,0,1820,1945,True,221,46,sebsi:1  marzouki:1  
16,9,9,232,1,481,261,600,0,339,261,600,0,0,233,20,8,261,0,1810,1833,True,189,44,sebsi:1  marzouki:1  
16,9,9,231,1,415,157,500,0,343,157,500,0,0,146,9,2,157,0,1810,1845,True,97,49,sebsi:1  marzouki:1  
16,9,9,230,1,509,254,600,1,345,254,600,0,0,236,15,3,254,0,,1910,True,212,24,sebsi:1  marzouki:1  
16,9,8,229,1,145,38,200,0,162,38,200,0,0,37,1,0,38,0,1815,,True,19,18,sebsi:  marzouki:  
16,9,8,228,1,337,83,400,0,317,83,400,0,0,83,0,0,83,0,1802,1824,True,59,24,sebsi:  marzouki:  
16,9,8,227,1,318,113,400,0,287,113,400,0,0,110,3,0,113,0,1820,1850,True,87,23,sebsi:  marzouki:  
16,9,8,226,3,417,88,500,0,412,88,500,400,0,85,2,1,88,0,1800,1820,True,36,49,sebsi:1  marzouki:1  
16,9,8,226,2,417,102,500,0,398,102,500,0,0,98,1,3,102,0,,1824,True,60,38,sebsi:1  marzouki:1  
16,9,8,226,1,417,214,496,0,282,214,496,0,0,212,1,1,214,0,1800,1830,True,174,38,sebsi:  marzouki:  
16,9,6,224,1,67,27,100,0,73,27,100,0,0,27,0,0,27,0,1800,1830,True,22,5,sebsi:1  marzouki:1  
16,9,6,223,2,474,143,500,0,357,143,500,0,0,135,8,0,143,0,1810,1830,True,96,39,sebsi:1  marzouki:1  
16,9,6,223,1,475,222,500,0,278,222,500,0,0,215,5,2,222,0,1800,1845,True,189,26,sebsi:1  marzouki:1  
16,9,6,222,2,417,84,500,0,416,84,500,0,0,80,1,3,84,0,1805,1830,True,58,22,sebsi:1  marzouki:1  
16,9,6,222,1,418,162,500,0,338,162,500,0,0,155,7,0,162,0,1810,1900,True,129,26,sebsi:  
16,9,6,221,1,223,119,300,0,181,119,300,0,0,116,0,3,119,0,1800,1900,True,66,50,sebsi:  
16,9,5,220,2,418,103,500,0,397,103,500,0,0,102,1,0,103,0,1800,1835,False,67,35,sebsi:  
16,9,5,220,1,418,189,500,0,311,189,500,0,0,187,1,1,189,0,1810,1830,True,141,46,sebsi:  
16,9,5,219,2,374,88,400,0,312,88,400,0,0,85,3,0,88,0,,1855,True,29,56,sebsi:  
16,9,4,218,3,548,210,602,0,392,210,602,0,0,208,1,1,210,0,1815,1834,True,104,104,sebsi:  marzouki:  
16,9,4,218,2,548,258,600,0,342,258,600,0,0,258,0,0,258,0,1818,1850,True,161,97,sebsi:  marzouki:  
16,9,4,218,1,548,325,600,0,275,325,600,0,0,318,4,3,325,0,1805,1900,True,232,86,sebsi:  marzouki:  
16,9,3,217,2,303,38,400,0,362,38,400,0,0,35,3,0,38,0,1805,1815,True,23,12,sebsi:  
16,9,3,217,1,303,103,400,0,297,103,400,0,0,100,2,1,103,0,1805,1826,True,78,22,sebsi:  
16,9,3,216,3,410,102,500,0,398,102,500,0,0,100,2,0,102,0,1802,1830,True,60,40,sebsi:  
16,9,3,216,2,412,147,500,2,351,147,500,0,0,147,0,0,147,0,1810,1835,True,94,53,sebsi:  
16,9,3,216,1,412,238,496,0,258,238,496,0,0,234,3,1,238,0,,1800,True,192,42,sebsi:  marzouki:  
16,9,2,215,1,199,50,300,1,249,50,300,0,0,49,1,0,50,0,1805,1820,True,36,13,sebsi:  
16,9,2,214,1,298,101,400,0,299,101,400,0,0,101,0,0,101,0,1800,1830,True,76,25,sebsi:  
16,9,2,213,1,527,187,600,0,413,187,600,0,0,181,4,2,187,0,1820,1930,True,135,46,sebsi:  marzouki:  
16,9,2,212,1,344,132,400,0,268,132,400,0,0,126,1,5,132,0,1815,1900,False,109,17,sebsi:  
16,9,2,211,1,312,138,400,0,262,138,400,0,0,134,3,1,138,0,1815,1850,True,94,40,sebsi:  
16,9,1,210,1,592,305,700,0,395,305,700,0,0,294,5,6,305,0,1800,1900,True,243,51,sebsi:1  marzouki:1  
16,9,1,209,1,410,183,500,0,317,183,500,0,0,178,2,3,183,0,1805,1845,True,115,63,sebsi:1  marzouki:1  
16,9,1,208,2,300,106,400,0,294,106,400,0,0,103,1,2,106,0,1800,1826,True,44,59,sebsi:  marzouki:  
16,9,1,208,1,301,153,400,0,247,153,400,0,0,151,1,1,153,0,1810,1834,True,82,69,sebsi:  marzouki:  
16,9,1,207,1,537,224,601,1,376,224,601,0,0,211,12,1,224,0,1805,1900,True,91,120,sebsi:  
16,1,16,50,1,244,155,302,0,147,155,302,0,0,154,1,0,155,0,1805,1845,True,111,43,sebsi:1  marzouki:1  
16,1,16,49,1,585,300,700,0,400,300,700,0,0,290,7,3,300,0,1815,1856,True,171,119,sebsi:1  marzouki:1  
16,1,15,48,1,289,130,400,0,270,130,400,0,0,126,3,1,130,0,,1834,True,78,48,sebsi:1  marzouki:1  
16,1,15,47,1,316,196,400,0,204,196,400,0,0,190,3,3,196,0,1800,1840,True,125,65,sebsi:1  marzouki:1  
16,1,15,46,2,455,158,500,0,341,158,499,1,0,157,1,0,158,0,1815,1838,True,72,85,sebsi:1  marzouki:1  
16,1,15,46,1,456,262,500,0,238,262,500,0,0,258,4,0,262,0,1805,1830,True,157,101,sebsi:1  marzouki:1  
16,1,14,45,1,192,84,300,0,216,84,300,0,0,79,5,0,84,0,1810,1834,True,47,32,sebsi:1  marzouki:1  
16,1,14,44,1,218,87,300,0,213,87,300,0,0,85,1,1,87,0,1808,1850,True,58,27,sebsi:1  marzouki:0  
16,1,14,43,1,182,87,200,0,113,87,200,0,0,87,0,0,87,0,1805,1835,True,32,55,sebsi:1  marzouki:1  
16,1,14,42,2,454,66,500,0,434,66,500,0,0,66,0,0,66,0,1830,1850,True,13,53,sebsi:1  marzouki:1  
16,1,14,42,1,455,185,500,0,315,185,500,0,0,182,3,0,185,0,1820,1855,True,85,97,sebsi:1  marzouki:1  
16,1,14,41,2,324,68,400,1,331,68,400,0,0,66,1,1,68,0,1815,1830,True,17,49,sebsi:1  marzouki:1  
16,1,14,41,1,325,157,400,0,243,157,400,0,0,155,2,0,157,0,1810,1904,True,99,56,sebsi:1  marzouki:1  
16,1,13,40,1,507,231,600,0,369,231,600,0,0,226,4,1,231,0,1830,1900,True,126,100,sebsi:1  marzouki:1  
16,1,13,39,2,331,60,400,0,340,60,400,0,0,58,1,1,60,0,1810,1838,True,33,25,sebsi:0  marzouki:1  
16,1,13,39,1,332,130,400,0,270,130,400,0,0,127,3,0,130,0,1820,1846,True,78,49,sebsi:1  marzouki:1  
16,1,13,38,1,482,162,600,0,438,162,600,0,0,153,6,3,162,0,1803,1900,True,84,69,sebsi:1  marzouki:1  
16,1,12,37,1,332,127,400,0,273,127,400,0,0,127,0,0,127,0,1815,1900,True,47,80,sebsi:1  marzouki:1  
16,1,12,36,2,527,167,600,0,433,167,600,0,0,162,5,0,167,0,1810,1830,True,72,90,sebsi:0  marzouki:1  
16,1,12,36,1,527,297,600,0,303,297,600,0,0,294,3,0,297,0,1805,1830,True,174,120,sebsi:1  marzouki:1  
16,1,12,35,2,428,125,499,0,374,125,499,0,0,124,1,0,125,0,1805,1836,True,43,81,sebsi:1  marzouki:1  
16,1,12,35,1,428,249,500,0,251,249,500,0,0,244,5,0,249,0,1800,1845,True,140,104,sebsi:1  marzouki:1  
16,1,11,34,2,382,112,500,0,388,112,500,0,0,108,2,2,112,0,1830,1900,True,55,53,sebsi:1  marzouki:1  
16,1,11,34,1,382,179,500,1,321,178,500,0,1,175,2,1,178,0,1810,1840,True,131,44,sebsi:1  marzouki:1  
16,1,11,33,1,451,176,500,0,324,176,500,0,0,174,0,2,176,0,1830,1845,True,99,75,sebsi:1  marzouki:1  
16,1,10,32,2,444,69,500,0,431,69,500,0,0,68,0,1,69,0,1805,1845,True,35,33,sebsi:1  marzouki:1  
16,1,10,32,1,445,187,500,0,313,187,500,0,0,186,1,0,187,0,1800,1825,True,127,59,sebsi:1  marzouki:0  
16,1,10,31,1,560,178,600,0,422,178,600,0,0,178,0,0,178,0,1810,1830,True,86,92,sebsi:1  marzouki:1  
16,1,9,30,1,264,125,300,1,174,125,300,0,0,120,2,3,125,0,1815,1830,True,50,70,sebsi:1  marzouki:1  
16,1,9,29,1,294,107,400,0,293,107,400,0,0,103,1,3,107,0,1800,1815,True,48,55,sebsi:1  marzouki:0  
16,1,9,28,2,407,139,500,0,361,139,500,0,0,131,6,2,139,0,1815,1840,True,48,83,sebsi:1  marzouki:1  
16,1,8,27,1,294,130,400,0,270,130,400,0,0,129,1,0,130,0,1815,1835,True,66,63,sebsi:1  marzouki:1  
16,1,8,26,1,270,94,300,0,206,94,300,0,0,93,1,0,94,0,1810,1830,True,78,15,sebsi:1  marzouki:1  
16,1,8,25,2,318,109,400,1,290,109,400,0,0,108,1,0,109,0,1820,1846,True,93,15,sebsi:1  marzouki:1  
16,1,8,25,1,319,160,400,0,240,160,400,0,0,157,3,0,160,0,1820,1856,True,149,8,sebsi:1  marzouki:1  
16,1,7,24,1,534,207,600,1,392,207,600,0,0,205,2,0,207,0,1810,1850,True,121,84,sebsi:1  marzouki:1  
16,1,7,23,1,440,131,500,0,369,131,500,0,0,127,3,1,131,0,1825,1846,True,62,65,sebsi:0  marzouki:1  
16,1,7,22,1,172,75,200,0,125,75,200,0,0,74,1,0,75,0,1812,1835,True,39,35,sebsi:1  marzouki:1  
16,1,6,21,1,331,154,400,0,246,154,400,0,0,150,3,1,154,0,1800,1841,True,76,74,sebsi:1  marzouki:1  
16,1,6,20,1,267,104,300,0,196,104,300,0,0,103,0,1,104,0,1820,1845,True,51,52,sebsi:1  marzouki:1  
16,1,6,19,1,328,165,400,1,234,165,400,0,0,162,2,1,165,0,1800,1830,True,67,95,sebsi:1  marzouki:1  
16,1,6,18,1,348,193,400,0,207,193,400,0,0,186,5,2,193,0,1810,1845,True,93,93,sebsi:1  marzouki:1  :  
16,1,6,17,1,176,95,200,0,105,95,200,0,0,93,1,1,95,0,1815,1843,True,37,56,sebsi:1  marzouki:1  
16,1,6,16,1,403,162,498,0,336,162,498,0,0,157,3,2,162,0,1825,1900,True,90,67,sebsi:1  marzouki:1  
16,1,6,15,2,345,78,400,0,322,78,400,0,0,76,2,0,78,0,1820,1840,True,32,44,sebsi:1  marzouki:1  
16,1,6,15,1,345,163,400,0,237,163,400,0,0,160,3,0,163,0,1805,1900,True,110,50,sebsi:1  marzouki:0  
16,1,5,14,1,348,169,400,0,231,169,400,0,0,168,1,0,169,0,1805,1832,True,109,59,sebsi:1  marzouki:1  
16,1,5,13,1,329,134,394,0,260,134,394,0,0,131,2,1,134,0,1810,1837,True,94,37,sebsi:1  marzouki:1  
16,1,5,12,1,184,63,200,0,137,63,200,0,0,61,0,2,63,0,1810,1845,True,47,14,sebsi:1  marzouki:1  
16,1,4,10,1,315,130,400,0,270,130,400,0,0,126,1,3,130,0,1815,1845,True,76,50,sebsi:1  marzouki:1  
16,1,4,9,1,328,132,400,0,268,132,400,0,0,129,2,1,132,0,1815,1830,True,59,70,sebsi:1  marzouki:1  
16,1,4,8,2,456,161,500,0,339,161,500,0,0,155,3,3,161,0,1815,1850,True,118,37,sebsi:1  marzouki:1  
16,1,4,8,1,456,258,499,0,242,257,499,0,1,252,3,2,257,0,1815,1854,True,206,46,sebsi:1  marzouki:1  
16,1,3,7,1,285,83,300,0,217,83,300,0,0,80,1,2,83,0,1814,1835,True,53,27,sebsi:1  marzouki:1  
16,1,3,6,1,385,128,500,0,372,128,500,0,0,124,3,1,128,0,1810,1855,True,59,65,sebsi:1  marzouki:0  
16,1,3,5,3,587,158,700,0,542,158,700,0,0,155,2,1,158,0,1810,1845,True,48,107,sebsi:1  marzouki:1  
16,1,3,5,2,588,239,700,0,461,239,700,0,0,238,0,1,239,0,1810,1845,True,90,148,sebsi:1  marzouki:1  
16,1,3,5,1,588,327,700,0,373,327,700,0,0,324,3,0,327,0,1810,1850,True,162,162,sebsi:1  marzouki:1  
16,1,2,4,1,490,181,600,0,419,181,600,0,0,176,3,2,181,0,1800,1825,True,78,98,sebsi:1  marzouki:1  
16,1,1,3,2,511,231,600,0,369,231,600,0,0,219,9,3,231,0,1815,1915,True,89,130,sebsi:1  marzouki:1  
16,1,1,3,1,512,323,614,1,290,323,614,0,0,322,1,0,323,0,1830,1930,True,190,132,sebsi:1  marzouki:1  
16,1,1,2,3,569,228,600,0,372,228,600,0,0,223,3,2,228,0,1802,1908,True,55,168,sebsi:1  marzouki:1  
16,1,1,2,2,569,304,600,0,296,304,600,0,0,300,2,2,304,0,1815,1915,True,114,186,sebsi:1  marzouki:1  
16,1,1,2,1,569,386,599,0,213,386,599,0,0,381,2,3,386,0,1810,1854,True,180,201,sebsi:1  marzouki:1  
16,1,1,1,7,545,246,600,0,354,246,600,0,0,238,5,3,246,0,1820,1812,True,75,163,sebsi:1  marzouki:1  
16,1,1,1,6,600,223,600,0,377,223,600,0,0,215,6,2,223,0,1810,1900,True,76,139,sebsi:1  marzouki:1  
16,1,1,1,5,549,237,600,0,363,237,600,0,0,234,1,2,237,0,1815,1855,True,101,133,sebsi:1  marzouki:1  
16,1,1,1,4,549,289,600,0,311,289,600,0,0,283,4,2,289,0,1810,1855,True,128,155,sebsi:1  marzouki:1  
16,1,1,1,3,549,335,600,1,264,335,600,0,0,326,7,2,335,0,1800,1940,True,164,162,sebsi:1  marzouki:1  
16,1,1,1,2,549,342,600,0,258,342,600,0,0,334,4,4,342,0,1820,1842,True,184,150,sebsi:1  marzouki:1  
16,1,1,1,1,549,359,601,0,242,359,601,0,0,352,4,3,359,0,1800,1915,True,232,120,sebsi:1  marzouki:1  
16,4,9,114,1,591,195,700,0,505,195,700,0,0,190,5,0,195,0,1810,1843,True,150,40,sebsi:1  marzouki:1  
16,4,9,113,1,380,219,400,0,181,219,400,0,0,214,5,0,219,0,1805,1825,True,189,25,sebsi:1  marzouki:0  
16,4,9,112,1,364,120,400,0,280,120,400,0,0,119,0,1,120,0,1815,1830,True,81,38,sebsi:1  marzouki:0  
16,4,8,111,2,384,31,500,0,469,31,500,0,0,31,0,0,31,0,1810,1830,True,21,10,sebsi:1  marzouki:0  
16,4,8,111,1,384,126,500,0,374,126,500,0,0,119,7,0,126,0,1800,1850,True,79,40,sebsi:1  marzouki:0  
16,4,8,110,2,501,194,600,0,406,194,600,0,0,189,5,0,194,0,1815,1853,True,122,67,sebsi:1  marzouki:0  
16,4,8,110,1,502,277,608,0,331,277,608,0,0,275,0,2,277,0,1820,1920,True,190,85,sebsi:1  marzouki:1  
16,4,7,109,1,539,268,600,0,332,268,600,0,0,261,4,3,268,0,1815,1930,True,219,42,sebsi:1  marzouki:1  
16,4,6,108,1,129,49,200,0,151,49,200,0,0,47,2,0,49,0,1800,1830,True,32,15,sebsi:1  marzouki:1  
16,4,6,107,1,390,170,500,0,330,170,500,0,0,161,8,1,170,0,1800,1839,True,109,52,sebsi:1  marzouki:0  
16,4,6,106,1,449,180,500,0,320,180,500,0,0,179,0,1,180,0,1810,1850,True,131,48,sebsi:1  marzouki:0  
16,4,5,105,1,550,226,600,0,374,226,600,0,0,221,5,0,226,0,1815,1850,True,177,44,sebsi:1  marzouki:1  :  
16,4,5,104,1,447,148,500,0,352,148,500,0,0,147,0,1,148,0,1800,1830,True,105,42,sebsi:1  marzouki:1  :  
16,4,5,103,1,337,136,400,0,264,136,400,0,0,134,1,1,136,0,1820,1900,True,110,24,sebsi:1  marzouki:1  :  
16,4,5,102,2,310,82,400,0,318,82,400,0,0,81,0,1,82,0,1800,1835,True,55,26,sebsi:1  marzouki:0  
16,4,5,102,1,310,167,400,0,233,167,400,0,0,162,4,1,167,0,1830,1910,True,129,33,sebsi:1  marzouki:1  
16,4,4,101,1,198,79,300,0,221,79,300,0,0,75,3,1,79,0,1800,1900,True,63,12,sebsi:1  marzouki:0  
16,4,3,100,1,156,71,200,0,129,71,200,0,0,70,0,1,71,0,1810,1830,True,27,43,sebsi:1  marzouki:1  
16,4,3,99,1,256,106,300,0,194,106,300,0,0,104,2,0,106,0,1800,,True,53,51,sebsi:1  marzouki:1  
16,4,3,98,2,303,93,400,0,307,93,400,0,0,92,1,0,93,0,1800,1823,True,29,63,sebsi:1  marzouki:1  
16,4,3,98,1,304,154,400,0,246,154,400,0,0,147,4,3,154,0,1810,1830,True,80,67,sebsi:1  marzouki:0  
16,4,3,97,1,85,43,100,1,56,43,100,0,0,43,0,0,43,0,,1830,True,29,14,sebsi:1  marzouki:0  
16,4,2,96,1,263,91,300,0,209,91,300,0,0,88,1,2,91,0,1805,1835,True,71,17,sebsi:1  marzouki:0  
16,4,2,95,1,250,100,300,0,200,100,300,0,0,99,1,0,100,0,1805,1817,True,89,10,sebsi:1  marzouki:0  
16,4,2,94,2,363,93,400,0,307,93,400,0,0,90,3,0,93,0,1800,1900,True,80,10,sebsi:1  marzouki:0  
16,4,2,94,1,364,162,400,0,238,162,400,0,0,155,3,4,162,0,1800,1855,True,136,19,sebsi:1  marzouki:0  
16,4,1,93,2,342,170,400,0,230,170,400,0,0,164,3,3,170,0,1820,1920,True,125,39,sebsi:1  marzouki:0  
16,4,1,93,1,343,237,400,0,163,237,400,0,0,233,3,1,237,0,1800,1900,True,198,35,sebsi:1  marzouki:1  
16,4,1,92,1,347,164,400,0,236,164,400,0,0,160,2,2,164,0,1800,,True,129,31,sebsi:1  marzouki:1  
16,4,1,91,1,251,106,303,0,197,106,303,0,0,99,4,3,106,0,1800,1830,True,61,38,sebsi:1  marzouki:1  
16,4,1,90,3,497,153,600,0,447,153,600,0,0,150,2,1,153,0,1810,1900,True,114,36,sebsi:1  marzouki:0  
16,4,1,90,2,499,279,600,0,321,279,600,0,0,273,5,1,279,0,1810,1855,True,211,62,sebsi:1  marzouki:0  
16,4,1,90,1,499,309,600,0,291,309,600,0,0,300,7,2,309,0,1830,1920,True,253,47,sebsi:1  marzouki:0  
16,2,8,73,1,316,132,400,0,268,132,400,0,0,129,3,0,132,0,1810,1830,True,62,67,sebsi:1  marzouki:1  
16,2,8,72,2,494,175,600,0,425,175,600,0,0,168,5,2,175,0,11815,,True,130,38,sebsi:1  marzouki:1  
16,2,8,72,1,495,266,600,0,334,266,600,0,0,256,8,2,266,0,1808,1835,True,200,56,sebsi:1  marzouki:1  
16,2,7,70,1,542,211,600,0,389,211,600,0,0,208,2,1,211,0,1805,,True,116,92,sebsi:1  marzouki:1  
16,2,7,69,1,491,191,600,0,409,191,600,0,0,180,7,4,191,0,1810,1830,True,115,65,sebsi:1  marzouki:0  
16,2,6,68,1,318,120,400,0,280,120,400,0,0,119,1,0,120,0,1805,1825,True,43,76,sebsi:1  marzouki:1  
16,2,6,67,2,356,157,398,0,241,157,398,0,0,157,0,0,157,0,1800,1840,True,58,99,sebsi:1  marzouki:1  
16,2,6,67,1,356,183,400,0,217,183,400,0,0,172,11,0,183,0,1800,,True,84,88,sebsi:1  marzouki:1  
16,2,6,66,1,439,149,500,0,351,149,500,0,0,146,2,1,149,0,1810,1835,True,64,82,sebsi:1  marzouki:1  
16,2,6,65,1,288,131,400,0,269,131,400,0,0,130,1,0,131,0,,1826,True,45,85,sebsi:1  marzouki:1  
16,2,6,64,1,270,129,300,0,171,129,300,0,0,126,1,2,129,0,1805,1840,True,68,58,sebsi:1  marzouki:1  
16,2,5,63,1,172,109,200,0,91,109,200,0,0,109,0,0,109,0,1810,1848,True,79,30,sebsi:1  marzouki:1  
16,2,5,62,1,564,291,600,1,308,291,600,0,0,284,6,1,291,0,1815,1840,True,192,92,sebsi:1  marzouki:0  
16,2,4,61,1,369,117,400,0,283,117,400,0,0,114,2,1,117,0,1810,1823,True,60,54,sebsi:1  marzouki:1  
16,2,3,59,1,189,81,200,0,119,81,200,0,0,78,3,0,81,0,1815,1915,True,43,35,sebsi:1  marzouki:1  
16,2,3,58,1,314,79,400,0,321,79,400,0,0,77,2,0,79,0,1800,1820,True,57,20,sebsi:0  marzouki:0  
16,2,2,57,1,93,29,100,0,71,29,100,0,0,29,0,0,29,0,,1825,True,7,22,sebsi:1  marzouki:1  
16,2,2,56,2,314,109,400,0,291,109,400,0,0,109,0,0,109,0,1815,1830,True,74,35,sebsi:1  marzouki:0  
16,2,2,56,1,315,171,400,0,229,171,400,0,0,166,2,3,171,0,1815,1900,True,115,51,sebsi:1  marzouki:0  
16,2,2,55,1,182,78,204,0,126,78,204,0,0,77,0,1,78,0,1815,1840,True,55,22,sebsi:0  marzouki:0  
16,2,2,54,1,121,33,200,0,167,33,200,0,0,30,2,1,33,0,1810,1825,True,17,13,sebsi:0  marzouki:0  
16,2,1,53,3,458,215,500,0,285,215,500,0,0,208,7,0,215,0,1810,1840,True,98,110,sebsi:1  marzouki:0  
16,2,1,53,2,458,273,500,0,227,273,500,0,0,268,3,2,273,0,1815,1904,True,157,111,sebsi:1  marzouki:0  
16,2,1,53,1,458,317,500,0,183,317,500,0,0,305,11,1,317,0,1805,1900,True,217,88,sebsi:1  marzouki:0  
16,2,1,52,2,521,262,600,0,338,262,600,0,0,259,3,0,262,0,1809,1841,True,136,123,sebsi:0  marzouki:0  
16,2,1,52,1,522,375,600,0,225,375,600,0,0,369,6,0,375,0,1805,1855,True,250,119,sebsi:0  marzouki:0  
16,2,1,51,4,465,209,500,0,291,209,500,0,0,203,4,2,209,0,1800,1800,True,115,88,sebsi:0  marzouki:0  
16,2,1,51,3,466,261,500,0,239,261,500,0,0,259,5,1,261,0,1801,,True,156,99,sebsi:0  marzouki:0  
16,2,1,51,2,466,325,500,0,175,325,500,0,0,318,4,3,325,0,1800,1900,True,211,107,sebsi:0  marzouki:0  
16,2,1,51,1,466,333,500,1,166,333,500,0,0,322,8,3,333,0,1805,1856,True,239,83,sebsi:1  marzouki:1  
16,12,6,316,1,59,19,100,0,81,19,100,0,0,19,0,0,19,0,1810,1825,True,5,14,sebsi:0  marzouki:0  
16,12,6,315,1,248,87,300,0,213,87,300,0,0,81,5,1,87,0,1810,1830,True,70,11,sebsi:1  marzouki:1  
16,12,6,314,1,403,203,500,0,297,203,500,0,0,196,7,0,203,0,1815,1900,True,117,79,sebsi:1  marzouki:0  
16,12,6,313,1,129,41,200,0,159,41,200,0,0,40,0,1,41,0,1810,1825,True,18,22,sebsi:1  marzouki:0  
16,12,6,312,1,382,179,506,0,327,179,506,0,0,174,2,3,179,0,1830,1949,True,56,118,sebsi:1  marzouki:1  
16,12,5,311,1,147,76,200,0,124,76,200,0,0,71,5,0,76,0,1800,1825,True,37,34,sebsi:0  marzouki:0  
16,12,5,310,1,337,130,401,0,271,130,401,0,0,129,0,1,130,0,,,True,84,45,sebsi:1  marzouki:1  
16,12,5,309,2,451,177,500,0,323,177,500,0,0,170,3,4,177,0,1805,1823,True,94,76,sebsi:1  marzouki:1  
16,12,5,308,1,224,65,300,0,235,65,300,0,0,64,1,0,65,0,1815,1832,True,54,10,sebsi:1  marzouki:1  
16,12,4,307,1,158,52,200,0,148,52,200,0,0,49,3,0,52,0,1815,1845,True,26,23,sebsi:1  marzouki:1  
16,12,4,306,1,313,138,400,0,262,138,400,0,0,134,1,3,138,0,1805,1835,True,32,102,sebsi:1  marzouki:1  
16,12,4,305,1,291,59,400,0,341,59,400,0,0,55,4,0,59,0,1820,1836,True,46,9,sebsi:0  marzouki:1  
16,12,4,304,1,288,121,400,0,279,121,400,0,0,121,0,0,121,0,,1830,True,38,83,sebsi:1  marzouki:1  
16,12,4,303,1,142,65,200,0,135,65,200,0,0,61,0,4,65,0,1815,1830,True,36,25,sebsi:0  marzouki:0  
16,12,3,302,1,302,107,400,0,293,107,400,0,0,104,1,2,107,0,1815,1840,True,59,45,sebsi:1  marzouki:1  
16,12,3,301,1,325,144,400,1,255,144,400,0,0,138,4,2,144,0,1823,1846,True,72,66,sebsi:1  marzouki:1  
16,12,3,300,1,255,119,300,0,181,119,300,0,0,112,3,4,119,0,1830,1845,True,38,74,sebsi:1  marzouki:1  
16,12,3,299,2,431,113,500,0,387,113,500,0,0,106,7,0,113,0,1815,1900,True,32,74,sebsi:1  marzouki:1  
16,12,3,299,1,431,211,501,0,290,211,501,0,0,202,7,2,211,0,1820,1920,True,94,108,sebsi:1  marzouki:1  
16,12,2,298,3,476,163,600,0,437,163,600,0,0,158,4,1,163,0,1800,1850,True,111,47,sebsi:1  marzouki:1  
16,12,2,298,2,477,226,600,0,374,226,600,0,0,216,7,3,226,0,1800,1841,True,170,46,sebsi:1  marzouki:1  
16,12,2,298,1,477,264,600,0,336,264,600,0,0,248,14,2,264,0,1810,1840,True,203,45,sebsi:1  marzouki:1  
16,12,1,297,1,104,47,200,0,153,47,200,0,0,47,0,0,47,0,1815,1830,True,26,21,sebsi:1  marzouki:0  
16,12,1,296,5,518,176,600,0,424,176,600,0,0,164,9,3,176,0,1815,1849,True,74,90,sebsi:1  marzouki:1  
16,12,1,296,4,521,170,599,1,428,170,599,0,0,159,9,2,170,0,1800,1850,True,80,79,sebsi:1  marzouki:1  
16,12,1,296,3,521,209,600,0,391,209,600,0,0,200,6,3,209,0,1805,1850,True,106,94,sebsi:1  marzouki:1  
16,12,1,296,2,521,300,600,0,300,300,600,0,0,286,6,8,300,0,1801,1900,True,182,104,sebsi:1  marzouki:1  
16,12,1,296,1,521,302,600,0,298,302,600,0,0,290,11,1,302,0,1815,1858,True,210,80,sebsi:1  marzouki:1  
16,12,1,295,1,244,93,300,0,207,93,300,0,0,87,3,3,93,0,1810,1825,True,39,48,sebsi:1  marzouki:1  
16,12,1,294,1,94,37,100,0,63,37,100,0,0,29,6,2,37,0,1805,1817,True,11,18,sebsi:0  marzouki:1  
16,12,1,293,1,560,124,600,1,475,124,600,0,0,121,2,1,124,0,1805,1835,True,101,20,sebsi:1  marzouki:0  
16,12,1,292,2,340,114,400,0,286,114,400,0,0,104,3,7,114,0,1800,1844,True,57,47,sebsi:1  marzouki:1  
16,12,1,292,1,341,153,400,0,247,153,400,0,0,142,10,1,153,0,1810,1838,True,112,30,sebsi:1  marzouki:0  
16,12,1,291,1,84,20,100,0,80,20,100,0,0,20,0,0,20,0,1810,1830,True,13,7,sebsi:1  marzouki:0  
16,12,1,290,4,469,176,500,0,324,176,500,0,0,159,14,3,176,0,1820,1856,True,101,58,sebsi:1  marzouki:1  
16,12,1,290,3,470,187,500,0,313,187,500,0,0,176,9,2,187,0,,1830,True,121,55,sebsi:1  marzouki:1  
16,12,1,290,2,470,256,501,0,246,255,501,0,1,242,10,3,255,0,1805,1850,True,167,75,sebsi:1  marzouki:1  
16,12,1,290,1,470,254,496,0,242,254,496,0,0,248,2,4,254,0,1820,1900,True,193,55,sebsi:1  marzouki:1  
16,3,8,89,2,554,159,600,0,441,159,600,0,0,146,7,6,159,0,1815,1900,True,67,79,sebsi:0  marzouki:1  
16,3,8,89,1,555,226,600,0,374,226,600,0,0,219,4,3,226,0,1815,1918,True,139,80,sebsi:1  marzouki:1  
16,3,7,88,1,6,1,100,0,99,1,100,0,0,1,0,0,1,0,1800,1810,True,1,0,sebsi:0  marzouki:0  
16,3,7,87,1,423,186,500,1,313,186,500,0,0,177,6,3,186,0,1805,1835,True,78,99,sebsi:1  marzouki:0  
16,3,6,86,1,348,148,400,0,252,148,400,0,0,147,0,1,148,0,1800,1835,True,74,73,sebsi:0  marzouki:1  
16,3,5,85,2,428,144,500,0,356,144,500,0,0,138,2,4,144,0,1812,1849,True,68,70,sebsi:1  marzouki:1  
16,3,5,85,1,428,243,500,0,257,243,500,0,0,234,4,5,243,0,1820,1850,True,161,73,sebsi:1  marzouki:1  
16,3,5,84,5,552,190,600,0,410,190,600,0,0,175,12,3,190,0,1810,1900,True,78,97,sebsi:1  marzouki:1  
16,3,5,84,4,554,196,600,0,404,196,600,0,0,193,3,0,196,0,1820,1847,True,97,96,sebsi:1  marzouki:1  
16,3,5,84,3,554,248,600,0,352,248,600,0,0,241,4,3,248,0,1815,1840,True,125,116,sebsi:1  marzouki:1  
16,3,5,84,2,554,276,600,0,324,276,600,0,0,267,4,5,276,0,1800,1845,True,160,107,sebsi:1  marzouki:1  
16,3,5,84,1,554,308,601,0,293,308,601,0,0,294,12,2,308,0,1810,1910,True,213,81,sebsi:1  marzouki:1  
16,3,5,83,4,476,220,600,0,380,220,600,0,0,214,5,1,220,0,1800,1842,True,107,107,sebsi:1  marzouki:1  
16,3,5,83,3,478,227,600,0,373,227,600,0,0,225,0,2,227,0,1800,1900,True,115,110,sebsi:1  marzouki:1  :  
16,3,5,83,2,478,299,600,0,301,299,600,0,0,296,2,1,299,0,1800,1850,True,165,131,sebsi:1  marzouki:1  
16,3,5,83,1,478,315,600,1,284,315,600,0,0,311,2,2,315,0,1820,1854,True,206,105,sebsi:1  marzouki:1  
16,3,4,82,4,573,226,700,0,474,226,700,0,0,220,6,0,226,0,,1955,True,80,140,sebsi:1  marzouki:1  
16,3,4,82,2,573,363,700,0,337,363,700,0,0,357,5,1,363,0,1810,1935,True,171,186,sebsi:1  marzouki:1  
16,3,4,82,1,573,340,693,0,353,340,693,0,0,334,3,3,340,0,,1915,True,214,120,sebsi:1  marzouki:1  
16,3,3,81,1,199,102,301,0,199,102,301,0,0,94,5,3,102,0,1800,1900,True,61,33,sebsi:1  marzouki:1  
16,3,3,80,1,142,40,200,0,160,40,200,0,0,37,3,0,40,0,1805,1823,True,27,10,sebsi:1  marzouki:1  
16,3,3,79,1,318,92,400,0,308,92,400,0,0,89,3,0,92,0,1815,1830,True,45,44,sebsi:1  marzouki:1  
16,3,2,78,1,438,137,500,0,363,137,500,0,0,129,7,1,137,0,1815,1840,True,61,68,sebsi:1  marzouki:1  
16,3,2,77,1,300,103,400,0,297,103,400,0,0,101,1,1,103,0,1805,1830,True,75,26,sebsi:1  marzouki:1  
16,3,2,76,2,305,92,400,0,308,92,400,0,0,92,0,0,92,0,1800,1820,True,49,43,sebsi:1  marzouki:1  
16,3,2,76,1,306,143,400,0,257,143,400,0,0,139,2,2,143,0,1815,1900,True,111,28,sebsi:1  marzouki:1  
16,3,1,75,1,187,57,200,0,143,57,200,0,0,54,3,0,57,0,1810,1820,True,34,20,sebsi:1  marzouki:1  
16,3,1,74,1,186,32,200,0,168,32,200,0,0,31,1,0,32,0,1800,1915,True,17,14,sebsi:1  marzouki:0  
16,6,10,170,1,64,32,100,0,68,32,100,0,0,32,0,0,32,0,1830,1845,True,17,15,sebsi:1  marzouki:1  
16,6,10,169,2,442,187,500,0,313,187,500,0,0,184,1,2,187,0,1800,1900,True,79,105,sebsi:1  marzouki:1  
16,6,10,169,1,442,280,500,1,219,280,500,0,0,269,10,1,280,0,1815,1850,True,155,114,sebsi:0  marzouki:0  
16,6,10,168,1,375,159,400,0,241,159,400,0,0,154,1,4,159,0,1815,1850,True,77,77,sebsi:1  marzouki:1  
16,6,10,167,1,537,224,599,0,375,224,599,0,0,218,5,1,224,0,1820,1900,True,162,56,sebsi:1  marzouki:1  
16,6,10,166,1,324,147,400,0,253,147,400,0,0,144,2,1,147,0,1811,1853,True,92,52,sebsi:1  marzouki:1  
16,6,9,165,1,504,180,600,0,420,180,600,0,0,172,5,3,180,0,1810,1850,True,122,50,sebsi:1  marzouki:1  
16,6,9,164,1,522,211,600,0,389,211,600,0,0,207,3,1,211,0,1800,1930,True,50,157,sebsi:1  marzouki:1  
16,6,9,163,2,515,166,600,0,434,166,600,0,0,160,4,2,166,0,1815,1850,True,48,112,sebsi:1  marzouki:1  
16,6,9,163,1,516,273,600,0,327,273,600,0,0,265,5,3,273,0,1808,1900,True,118,147,sebsi:1  marzouki:1  
16,6,8,162,1,83,23,100,0,77,23,100,0,0,21,0,2,23,0,1810,1830,True,16,5,sebsi:0  marzouki:0  
16,6,8,161,2,374,77,400,0,323,77,400,0,0,74,0,3,77,0,1805,1825,True,40,34,sebsi:1  marzouki:1  
16,6,8,161,1,375,185,400,1,214,185,400,0,0,171,14,0,185,0,1800,1930,True,129,42,sebsi:0  marzouki:1  
16,6,7,160,1,356,97,400,0,303,97,400,0,0,94,3,0,97,0,1812,1830,True,45,49,sebsi:1  marzouki:1  :  
16,6,6,159,1,398,118,500,1,381,118,500,0,0,116,2,0,118,0,,,True,80,36,sebsi:1  marzouki:1  
16,6,6,158,2,371,105,400,0,295,105,400,0,0,103,2,0,105,0,1820,1855,True,66,37,sebsi:1  marzouki:1  
16,6,6,158,1,372,197,400,0,203,197,400,0,0,190,7,0,197,0,1815,1900,True,124,66,sebsi:1  marzouki:1  
16,6,5,157,1,227,69,300,0,231,69,300,0,0,67,2,0,69,0,1805,1825,True,33,34,sebsi:0  marzouki:1  
16,6,4,156,1,143,48,200,0,152,48,200,0,0,48,0,0,48,0,1810,1820,True,40,8,sebsi:1  marzouki:0  
16,6,4,155,1,433,166,500,0,334,166,500,0,0,162,1,3,166,0,1815,1835,True,139,23,sebsi:1  marzouki:1  
16,6,4,154,2,303,52,400,0,348,52,400,0,0,51,1,0,52,0,1810,1830,True,27,24,sebsi:0  marzouki:1  
16,6,4,154,1,303,168,400,1,231,168,400,0,0,160,8,0,168,0,1800,1920,True,70,90,sebsi:0  marzouki:1  
16,6,4,153,1,574,146,700,0,554,146,700,0,0,144,2,0,146,0,1805,1825,True,114,30,sebsi:1  marzouki:0  
16,6,4,152,1,269,92,300,0,208,92,300,0,0,85,7,0,92,0,1810,1825,True,26,59,sebsi:1  marzouki:1  
16,6,3,151,1,496,200,600,0,400,200,600,0,0,194,4,2,200,0,1810,1836,True,128,66,sebsi:1  marzouki:0  
16,6,3,150,1,440,203,500,0,297,203,500,0,0,202,0,1,203,0,1800,1827,True,90,112,sebsi:1  marzouki:1  
16,6,2,149,1,391,175,500,0,325,175,500,0,0,171,3,1,175,0,1800,1830,True,132,39,sebsi:2  marzouki:2  
16,6,2,148,1,358,139,400,0,261,139,400,0,0,135,2,2,139,0,1800,1815,True,83,52,sebsi:1  marzouki:1  :  
16,6,2,147,1,308,89,400,0,311,89,400,0,0,89,0,0,89,0,1805,1830,True,55,34,sebsi:1  marzouki:0  
16,6,2,146,1,362,124,400,2,274,124,400,0,0,120,4,0,124,0,1800,1820,True,54,66,sebsi:1  marzouki:1  
16,6,2,145,4,478,155,599,1,444,154,599,0,1,153,0,1,154,0,1800,1850,True,64,89,sebsi:1  marzouki:1  
16,6,2,145,3,478,163,600,0,437,163,600,0,0,162,1,0,163,0,1805,1835,True,82,80,sebsi:1  marzouki:1  
16,6,2,145,2,478,258,584,0,326,258,584,0,0,256,2,0,258,0,1810,1850,True,128,128,sebsi:1  marzouki:1  
16,6,2,145,1,478,265,600,0,335,265,600,0,0,261,3,1,265,0,1815,1848,True,167,94,sebsi:1  marzouki:1  
16,6,2,144,5,499,211,600,0,389,211,600,0,0,206,3,2,211,0,1800,1830,True,91,115,sebsi:1  marzouki:1  
16,6,2,144,4,502,188,600,0,412,188,600,0,0,183,3,2,188,0,1815,1830,True,88,95,sebsi:1  marzouki:1  
16,6,2,144,3,502,262,600,0,338,262,600,0,0,253,5,4,262,0,1810,1850,True,142,111,sebsi:0  marzouki:1  
16,6,2,144,2,502,319,600,0,281,319,600,0,0,311,5,3,319,0,1810,1900,True,160,151,sebsi:1  marzouki:1  
16,6,2,144,1,502,325,601,1,275,325,601,0,0,321,2,2,325,0,1805,1830,True,193,128,sebsi:1  marzouki:1  
16,6,1,143,1,291,135,400,0,265,135,400,0,0,135,0,0,135,0,,1830,True,60,75,sebsi:1  marzouki:1  
16,6,1,142,1,305,90,400,0,310,90,400,0,0,86,4,0,90,0,1810,1900,True,42,44,sebsi:1  marzouki:1  
16,6,1,141,1,497,174,600,0,426,174,600,0,0,168,5,1,174,0,1815,1900,True,116,52,sebsi:1  marzouki:1  
16,7,5,187,1,359,68,400,1,331,68,400,0,0,67,1,0,68,0,1815,1835,True,53,14,sebsi:1  marzouki:0  
16,7,5,186,1,15,11,100,0,89,11,100,0,0,11,0,0,11,0,,1810,True,8,3,sebsi:0  marzouki:0  
16,7,5,185,1,419,84,500,0,416,84,500,0,0,82,1,1,84,0,1800,1900,True,61,21,sebsi:1  marzouki:0  
16,7,4,184,1,252,58,300,0,242,58,300,0,0,58,0,0,58,0,1810,1822,True,53,5,sebsi:1  marzouki:0  
16,7,4,183,1,291,86,400,0,314,86,400,0,0,82,4,0,86,0,1815,1850,True,36,46,sebsi:1  marzouki:0  
16,7,4,182,2,509,69,600,0,531,69,600,0,0,67,2,0,69,0,1850,1925,True,44,23,sebsi:1  marzouki:1  
16,7,4,182,1,509,164,600,0,436,164,600,0,0,157,7,0,164,0,1823,1903,True,130,27,sebsi:1  marzouki:1  
16,7,4,181,2,386,68,500,0,432,68,500,0,0,67,1,0,68,0,1820,1840,True,52,15,sebsi:1  marzouki:1  
16,7,4,181,1,387,154,500,0,346,154,500,0,0,146,2,6,154,0,1814,1841,True,119,27,sebsi:1  marzouki:0  
16,7,3,180,2,343,43,400,0,357,43,400,0,0,41,2,0,43,0,1805,1830,True,14,27,sebsi:1  marzouki:1  
16,7,3,180,1,343,123,400,0,277,123,400,0,0,123,0,0,123,0,1810,1830,True,70,53,sebsi:1  marzouki:1  
16,7,3,179,1,404,103,500,0,397,103,500,0,0,101,1,1,103,0,1815,1845,True,70,31,sebsi:1  marzouki:1  
16,7,3,178,2,538,161,601,0,440,161,601,0,0,160,1,0,161,0,,1900,True,92,68,sebsi:1  marzouki:1  
16,7,3,178,1,538,238,600,0,362,238,600,0,0,234,3,1,238,0,1815,1850,True,169,65,sebsi:1  marzouki:1  
16,7,2,177,2,394,103,500,0,397,103,500,0,0,101,2,0,103,0,1830,1851,True,51,50,sebsi:1  marzouki:1  
16,7,2,177,1,395,181,500,0,319,181,500,0,0,177,3,1,181,0,1830,1855,True,91,86,sebsi:1  marzouki:1  
16,7,2,176,2,464,155,500,0,345,155,500,0,0,151,2,2,155,0,1835,1900,True,80,71,sebsi:1  marzouki:1  
16,7,2,176,1,464,203,500,0,297,203,500,0,0,198,5,0,203,0,1830,1930,True,112,86,sebsi:1  marzouki:1  
16,7,2,175,1,592,236,696,1,459,236,696,0,0,234,2,0,236,0,1829,1919,True,133,101,sebsi:1  marzouki:1  
16,7,2,174,2,384,79,500,0,421,79,500,0,0,77,1,1,79,0,1820,1845,True,41,36,sebsi:1  marzouki:1  
16,7,2,174,1,385,167,500,1,332,167,500,0,0,164,3,0,167,0,1810,1848,True,93,71,sebsi:1  marzouki:0  
16,7,1,173,1,593,245,700,1,454,245,700,0,0,237,5,3,245,0,1815,1920,True,96,141,sebsi:1  marzouki:1  
16,7,1,172,1,594,164,700,0,536,164,700,0,0,159,4,1,164,0,1828,1900,True,36,123,sebsi:1  marzouki:1  
16,7,1,171,4,590,150,700,0,550,150,700,0,0,142,7,1,150,0,1800,1900,True,43,99,sebsi:1  marzouki:1  
16,7,1,171,3,593,187,700,0,513,187,700,0,0,182,3,2,187,0,1810,1842,True,79,103,sebsi:1  marzouki:1  
16,7,1,171,2,593,276,700,1,423,276,700,0,0,271,4,1,276,0,1805,1850,True,99,172,sebsi:1  marzouki:1  
16,7,1,171,1,593,318,700,0,382,318,700,0,0,306,7,5,318,0,1805,1900,True,146,160,sebsi:1  marzouki:1  
16,5,9,140,1,435,171,500,0,329,171,500,0,0,164,6,1,171,0,1815,1840,True,101,63,sebsi:1  marzouki:0  
16,5,9,139,2,312,42,400,0,358,42,400,0,0,40,0,2,42,0,,1838,True,34,6,sebsi:1  marzouki:0  
16,5,9,139,1,312,151,396,0,245,151,396,0,0,148,2,1,151,0,1800,1835,True,132,16,sebsi:0  marzouki:0  
16,5,8,138,1,416,258,500,1,241,258,500,0,0,256,2,0,258,0,1815,1900,True,205,51,sebsi:1  marzouki:0  
16,5,8,137,1,384,190,500,0,310,190,500,0,0,187,3,0,190,0,1815,1830,True,171,16,sebsi:1  marzouki:0  
16,5,8,136,1,493,181,600,0,419,181,600,0,0,176,4,1,181,0,1810,1840,True,139,37,sebsi:1  marzouki:0  
16,5,8,135,2,507,211,600,0,389,211,600,0,0,204,4,3,211,0,1800,1840,True,184,20,sebsi:1  marzouki:1  
16,5,8,135,1,507,299,600,1,300,299,600,0,0,296,3,0,299,0,1820,1900,True,285,11,sebsi:1  marzouki:1  
16,5,7,134,1,229,85,300,0,215,85,300,0,0,83,2,0,85,0,1805,1833,True,58,25,sebsi:1  marzouki:0  
16,5,7,133,1,422,159,496,0,337,159,496,0,0,154,2,3,159,0,1800,1830,True,115,39,sebsi:1  marzouki:0  
16,5,7,132,2,375,89,400,0,311,89,400,0,0,88,0,1,89,0,1800,1830,False,52,36,sebsi:1  marzouki:0  
16,5,7,132,1,375,175,398,0,223,175,398,0,0,173,2,0,175,0,1810,1840,False,130,43,sebsi:1  marzouki:1  
16,5,6,131,1,255,67,303,0,236,67,303,0,0,66,1,0,67,0,1809,1855,True,29,37,sebsi:1  marzouki:0  
16,5,6,130,2,421,102,500,0,398,102,500,0,0,97,3,2,102,0,1810,1835,True,48,49,sebsi:1  marzouki:0  
16,5,6,130,1,422,216,500,0,284,216,500,0,0,215,1,0,216,0,1805,1830,False,165,50,sebsi:1  marzouki:0  
16,5,5,129,1,456,178,500,0,322,178,500,0,0,174,2,2,178,0,,1838,False,152,22,sebsi:1  marzouki:1  
16,5,5,128,1,368,121,400,0,279,121,400,0,0,115,4,2,121,0,1812,1856,True,66,49,sebsi:1  marzouki:1  
16,5,5,127,2,357,83,400,0,317,83,400,0,0,83,0,0,83,0,1800,1832,True,56,27,sebsi:1  marzouki:0  
16,5,5,127,1,358,180,400,0,220,180,400,0,0,172,6,2,180,0,1806,1900,True,151,21,sebsi:1  marzouki:0  
16,5,5,126,2,345,67,400,0,333,67,400,0,0,64,1,2,67,0,1810,1835,True,41,23,sebsi:1  marzouki:1  
16,5,5,126,1,345,181,401,1,219,181,401,0,0,174,4,3,181,0,1815,1842,True,131,43,sebsi:1  marzouki:1  
16,5,4,125,1,120,43,200,0,157,43,200,0,0,42,0,1,43,0,1800,1900,False,32,10,sebsi:1  marzouki:0  
16,5,4,124,1,91,57,100,0,43,57,100,0,0,56,0,1,57,0,1805,1820,True,50,6,sebsi:1  marzouki:0  
16,5,4,123,2,422,86,500,0,414,86,500,0,0,81,4,1,86,0,1808,1826,True,49,32,sebsi:1  marzouki:1  
16,5,4,123,1,422,156,500,0,344,156,500,0,0,156,0,0,156,0,1806,1844,True,118,38,sebsi:1  marzouki:1  
16,5,3,122,2,375,83,400,0,317,83,400,0,0,77,4,2,83,0,1820,1845,True,39,38,sebsi:1  marzouki:0  
16,5,3,122,1,375,164,400,1,235,164,400,0,0,159,3,2,164,0,1815,1900,True,99,60,sebsi:1  marzouki:1  
16,5,3,121,1,429,192,500,0,308,192,500,0,0,186,6,0,192,0,1805,1851,True,146,40,sebsi:1  marzouki:1  
16,5,2,120,1,57,23,100,0,77,23,100,0,0,21,0,2,23,0,1815,1828,True,11,10,sebsi:1  marzouki:0  
16,5,1,119,1,96,43,200,0,157,43,200,0,0,42,0,1,43,0,1805,1830,True,35,7,sebsi:0  marzouki:0  
16,5,1,118,4,516,194,600,0,406,194,600,0,0,176,13,5,194,0,1815,1850,True,104,72,sebsi:1  marzouki:0  
16,5,1,118,3,518,225,600,0,375,225,600,0,0,218,3,4,225,0,1813,1856,True,149,69,sebsi:1  marzouki:1  
16,5,1,118,2,518,316,600,1,283,316,600,0,0,304,6,6,316,0,1800,1927,True,222,82,sebsi:1  marzouki:0  
16,5,1,118,1,518,305,600,1,294,305,600,0,0,293,12,0,305,0,1819,,True,233,60,sebsi:1  marzouki:0  
16,5,1,117,3,425,143,500,0,357,143,500,0,0,141,1,1,143,0,1800,1900,True,78,63,sebsi:1  marzouki:0  
16,5,1,117,2,425,182,500,0,318,182,500,0,0,178,1,3,182,0,1800,1920,True,108,70,sebsi:1  marzouki:0  
16,5,1,117,1,425,203,500,0,297,203,500,0,0,201,1,1,203,0,1815,1855,True,156,45,sebsi:1  marzouki:0  
16,5,1,116,1,364,148,400,0,252,148,400,0,0,140,6,2,148,0,1805,1833,True,82,58,sebsi:1  marzouki:0  
16,5,1,115,4,534,185,600,0,415,185,600,0,0,179,5,1,185,185,1805,,True,117,62,sebsi:1  marzouki:0  
16,5,1,115,3,534,207,600,2,391,207,600,0,0,198,9,0,207,0,1808,1850,True,149,49,sebsi:1  marzouki:0  
16,5,1,115,2,534,314,600,0,286,314,600,0,0,309,5,0,314,0,1815,1845,True,251,58,sebsi:1  marzouki:0  
16,5,1,115,1,534,318,600,1,281,318,600,0,0,313,4,1,318,0,1815,1855,True,272,41,sebsi:1  marzouki:1  
16,11,7,289,1,448,187,500,0,313,187,500,0,0,186,0,1,187,0,1815,1845,True,109,77,sebsi:1  marzouki:1  
16,11,7,288,1,516,263,600,0,337,263,600,0,0,254,8,1,263,0,1820,1845,True,124,130,sebsi:1  marzouki:1  
16,11,6,287,1,309,136,400,0,264,136,400,0,0,136,0,0,136,0,1820,1840,True,115,21,sebsi:1  marzouki:1  
16,11,6,286,1,195,58,300,0,242,58,300,0,0,57,1,0,58,0,1800,1815,True,34,23,sebsi:1  marzouki:1  
16,11,5,285,2,374,89,400,0,311,89,400,0,0,89,0,0,89,0,,1830,True,32,57,sebsi:0  marzouki:0  
16,11,5,285,1,374,154,400,0,246,154,400,0,0,151,1,2,154,0,1801,1819,True,67,84,sebsi:1  marzouki:1  
16,11,4,284,1,285,100,301,1,200,100,301,0,0,97,3,0,100,0,1807,1831,True,51,46,sebsi:1  marzouki:1  
16,11,4,283,1,554,186,600,1,414,185,600,0,1,178,7,0,185,0,,1842,True,121,57,sebsi:1  marzouki:1  
16,11,3,282,1,468,172,500,0,328,172,500,0,0,172,0,0,172,0,1800,1837,True,89,83,sebsi:1  marzouki:1  
16,11,2,280,1,191,87,300,0,213,87,300,0,0,85,2,0,87,0,1820,1844,True,38,47,sebsi:1  marzouki:0  
16,11,2,279,1,297,130,400,0,270,130,400,0,0,129,1,0,130,0,1800,1830,True,77,52,sebsi:1  marzouki:1  
16,11,2,278,2,340,94,400,0,306,94,400,0,0,92,1,1,94,0,1805,1840,True,66,26,sebsi:1  marzouki:1  
16,11,2,278,1,341,167,400,0,233,167,400,0,0,161,1,5,167,0,1815,1845,True,138,23,sebsi:1  marzouki:0  
16,11,2,277,1,271,102,300,0,198,102,300,0,0,98,4,0,102,0,1800,1816,True,72,26,sebsi:1  marzouki:0  
16,11,2,276,1,268,102,300,0,198,102,300,0,0,99,2,1,102,0,1810,1822,True,86,13,sebsi:1  marzouki:1  
16,11,1,275,1,319,164,400,0,236,164,400,0,0,155,7,2,164,0,1820,1900,True,119,36,sebsi:1  marzouki:1  
16,11,1,274,2,589,232,700,1,467,232,700,0,0,221,8,3,232,0,1800,,True,104,117,sebsi:1  marzouki:1  
16,11,1,274,1,589,329,700,0,371,329,700,0,0,319,6,4,329,0,1813,1848,True,220,99,sebsi:1  marzouki:1  
16,11,1,273,1,366,116,400,0,284,116,400,0,0,115,1,0,116,0,1810,1832,True,96,19,sebsi:1  marzouki:0  
16,11,1,272,1,231,74,300,0,226,74,300,0,0,71,2,1,74,0,1810,1825,True,49,22,sebsi:1  marzouki:0  
16,11,1,271,5,516,221,598,0,377,221,598,0,0,210,5,6,221,0,1830,1900,True,108,102,sebsi:1  marzouki:1  
16,11,1,271,4,518,218,600,1,381,218,600,0,0,211,4,3,218,0,1820,1915,True,107,104,sebsi:1  marzouki:1  
16,11,1,271,3,518,306,600,0,294,306,600,0,0,299,5,2,306,0,1815,,True,179,120,sebsi:1  marzouki:1  
16,11,1,271,2,518,352,600,0,248,352,600,0,0,347,4,1,352,0,1815,1910,True,241,106,sebsi:1  marzouki:1  
