circonscriptionId,delegationId,subDelegationId,centerID,stationId,registeredVoters,aSigningVoters,bDeliveredBallots,cSpoiledBallots,dLeftBallots,fExtractedBallots,gEplusF,hBminusG,iAminusF,jListVotes,kCancelledVotes,lBlankVotes,mJplusKplusL,nFminusM,countingStart,countingEnd,tampon,sebsi,marzouki,observers
2,7,9,69,2,462,281,500,0,219,281,500,0,0,278,2,1,281,0,1835,1930,True,151,127,sebsi:1  marzouki:1  
2,7,9,69,1,463,351,500,3,147,350,500,0,1,340,7,3,350,0,1838,,False,216,124,sebsi:1  marzouki:1  
2,7,8,68,6,569,333,600,2,266,332,600,0,1,324,6,2,332,0,1823,1948,False,177,147,sebsi:1  marzouki:1  
2,7,8,68,5,571,376,600,1,223,376,600,0,0,367,6,3,376,0,1835,1945,False,174,193,sebsi:1  marzouki:1  
2,7,8,68,4,571,374,600,0,226,374,600,0,0,368,2,4,374,0,1830,1915,False,183,185,sebsi:1  marzouki:1  
2,7,8,68,3,571,414,600,0,187,413,600,0,1,404,8,1,413,0,1830,1930,False,242,162,sebsi:1  marzouki:1  
2,7,8,68,2,571,408,602,1,194,407,602,0,1,395,12,0,407,0,1835,1930,False,232,163,sebsi:1  marzouki:1  
2,7,8,68,1,571,425,588,1,162,425,588,0,0,411,7,7,425,0,1830,1925,False,271,140,sebsi:1  marzouki:1  
2,7,7,67,5,539,321,600,0,279,321,600,0,0,311,4,6,321,0,1820,1910,True,179,132,sebsi:1  marzouki:1  
2,7,7,67,4,542,350,596,0,246,350,596,0,0,345,4,1,350,0,1825,1920,True,183,162,sebsi:1  marzouki:1  
2,7,7,67,3,542,378,600,1,221,378,600,0,0,371,4,3,378,0,1830,1910,True,228,143,sebsi:1  marzouki:1  
2,7,7,67,2,542,401,600,0,199,401,600,0,0,393,3,5,401,0,1820,1930,False,289,104,sebsi:1  marzouki:1  
2,7,7,67,1,542,389,601,0,212,389,601,0,0,387,2,0,389,0,1815,1915,False,291,96,sebsi:1  marzouki:1  
2,7,7,66,4,594,372,700,1,328,371,700,0,1,360,7,4,371,0,1840,1940,False,210,150,sebsi:1  marzouki:1  
2,7,7,66,3,595,406,700,0,294,406,700,0,0,403,2,1,406,0,1830,1926,False,242,161,sebsi:1  marzouki:1  
2,7,7,66,2,595,452,700,0,248,452,700,0,0,444,4,4,452,0,1830,1930,True,293,151,sebsi:1  marzouki:1  
2,7,7,66,1,595,453,701,0,248,453,701,0,0,441,12,0,453,0,1855,,False,335,106,sebsi:1  marzouki:1  
2,7,6,65,6,554,333,600,0,267,333,600,0,0,327,6,0,333,0,1820,1905.,False,181,146,sebsi:1  marzouki:1  
2,7,6,65,5,555,352,600,0,248,352,600,0,0,346,4,2,352,0,1805,1910,True,187,159,sebsi:1  marzouki:1  
2,7,6,65,4,555,388,600,0,212,388,600,0,0,380,2,6,388,0,1810,1920,True,183,197,sebsi:1  marzouki:1  
2,7,6,65,3,600,394,600,0,206,394,600,0,0,388,2,4,394,0,1820,1905,False,202,186,sebsi:1  marzouki:1  
2,7,6,65,2,555,381,600,1,218,381,600,0,0,365,15,1,381,0,1815,1915,True,243,122,sebsi:1  marzouki:1  
2,7,6,65,1,555,408,600,0,192,408,600,0,0,390,13,4,407,1,1816,2000,False,261,129,sebsi:1  marzouki:1  
2,7,5,64,9,583,418,698,0,280,418,698,0,0,403,9,6,418,0,1820,1930,True,250,153,sebsi:1  marzouki:1  
2,7,5,64,8,583,428,700,1,271,428,700,0,0,418,4,6,428,0,1825,1930,True,256,162,sebsi:1  marzouki:1  
2,7,5,64,7,583,421,700,1,277,421,699,1,0,406,9,6,421,0,1800,2025,False,219,187,sebsi:1  marzouki:1  
2,7,5,64,6,583,445,700,2,253,445,700,0,0,440,3,2,445,0,1849,2015,False,250,190,sebsi:1  marzouki:1  
2,7,5,64,5,583,448,700,1,251,448,700,0,0,441,3,4,448,0,1830,1930,True,264,177,sebsi:1  marzouki:1  
2,7,5,64,4,583,471,700,0,229,471,700,0,0,461,3,7,471,0,1815,1930,True,271,190,sebsi:1  marzouki:1  
2,7,5,64,3,583,501,700,0,199,501,700,0,0,492,8,1,501,0,1810,1900,True,288,204,sebsi:1  marzouki:1  
2,7,5,64,1,583,475,695,3,219,473,695,0,2,464,6,3,473,0,1900,2025,True,299,165,sebsi:1  marzouki:1  
2,7,5,63,5,540,331,600,0,269,331,600,0,0,323,5,3,331,0,1815,1845,False,211,112,sebsi:1  marzouki:1  
2,7,5,63,4,542,319,600,1,280,319,600,0,0,313,2,4,319,0,1810,1900,False,174,139,sebsi:1  marzouki:1  
2,7,5,63,3,542,372,597,1,224,372,597,0,0,368,1,3,372,0,1830,1920,True,229,139,sebsi:1  marzouki:1  
2,7,5,63,2,542,406,600,1,193,406,600,0,0,396,8,2,406,0,1814,1905,False,256,140,sebsi:1  marzouki:1  
2,7,5,63,1,542,424,600,0,176,424,600,0,0,411,9,4,424,0,1815,1910,True,300,111,sebsi:  marzouki:  
2,7,4,62,1,406,295,500,0,205,295,500,0,0,290,3,2,295,0,1830,1920,True,192,98,sebsi:  marzouki:  
2,7,3,61,8,525,336,596,0,260,336,596,0,0,329,5,2,336,0,1810,1900,False,219,110,sebsi:  marzouki:  
2,7,3,61,7,528,369,600,2,229,369,600,0,0,360,3,6,369,0,1830,1915,True,252,108,sebsi:1  marzouki:1  
2,7,3,61,6,528,329,600,0,271,329,600,0,0,321,5,3,329,0,1808,1911,True,168,153,sebsi:  marzouki:  
2,7,3,61,5,528,409,600,2,189,409,600,0,0,404,2,3,409,0,,1940,True,275,129,sebsi:1  marzouki:1  
2,7,3,61,4,528,381,600,0,219,381,600,0,0,376,2,3,381,0,1815,1930,True,231,145,sebsi:1  marzouki:1  
2,7,3,61,3,528,419,600,2,179,419,600,0,0,410,5,4,419,0,1800,2000,False,284,126,sebsi:1  marzouki:1  
2,7,3,61,2,528,429,595,0,166,429,595,0,0,408,16,5,429,0,1830,1903,True,305,103,sebsi:1  marzouki:1  
2,7,3,61,1,528,413,600,0,187,413,600,0,0,406,5,2,413,0,1815,1915,True,300,106,sebsi:1  marzouki:1  
2,7,3,60,7,555,356,596,2,238,356,596,0,0,337,8,11,356,0,1830,2045,False,237,100,sebsi:1  marzouki:1  
2,7,3,60,6,555,376,600,3,221,376,600,0,0,366,6,4,376,0,1820,19213,True,270,96,sebsi:1  marzouki:1  
2,7,3,60,5,555,382,600,1,217,382,600,0,0,378,4,0,382,0,1824,1924,True,238,140,sebsi:1  marzouki:1  
2,7,3,60,4,555,410,599,2,187,410,599,0,0,402,5,3,410,0,1919,2005,False,270,132,sebsi:1  marzouki:1  
2,7,3,60,3,555,433,600,1,166,433,600,0,0,427,6,0,433,0,,2000,True,313,114,sebsi:1  marzouki:1  
2,7,3,60,2,555,428,600,1,171,428,600,0,0,417,10,1,428,0,1834,1937,True,321,96,sebsi:1  marzouki:1  
2,7,3,60,1,555,434,600,1,165,434,600,0,0,423,8,3,434,0,1830,1931,False,315,108,sebsi:1  marzouki:1  
2,7,2,59,7,578,364,703,1,338,364,703,0,0,353,5,6,364,0,1824,1933,True,201,152,sebsi:1  marzouki:1  
2,7,2,59,6,579,356,700,0,344,356,700,0,0,352,2,2,356,0,1830,1903,True,202,150,sebsi:1  marzouki:1  
2,7,2,59,5,579,421,700,4,275,421,700,0,0,411,7,3,421,0,1815,1910,True,267,144,sebsi:1  marzouki:1  
2,7,2,59,4,579,424,700,1,275,424,700,0,0,416,4,4,424,0,1820,1905,True,272,144,sebsi:1  marzouki:1  
2,7,2,59,3,579,455,700,0,245,455,700,0,0,449,5,1,455,0,449,5,True,281,168,sebsi:455  marzouki:1  
2,7,2,59,2,579,455,700,0,245,455,700,0,0,447,3,5,455,0,1815,1940,False,302,145,sebsi:1  marzouki:1  
2,7,2,59,1,579,459,700,2,239,459,700,0,0,450,7,2,459,0,1830,1933,False,331,119,sebsi:  marzouki:  
2,7,1,58,3,413,249,500,2,249,249,500,0,0,241,3,5,249,0,1825,1900,False,143,98,sebsi:1  marzouki:1  
2,7,1,58,2,415,276,500,0,224,276,500,0,0,268,3,5,276,0,1810,,True,169,99,sebsi:1  marzouki:1  
2,7,1,58,1,415,317,501,1,183,317,501,0,0,308,5,4,317,0,1823,1927,False,232,76,sebsi:1  marzouki:1  
2,7,1,57,7,595,375,700,0,325,375,700,0,0,357,9,9,375,0,1815,1920,True,215,142,sebsi:1  marzouki:1  
2,7,1,57,6,599,428,700,0,272,428,700,0,0,420,4,4,428,0,1812,1914,True,247,173,sebsi:1  marzouki:1  
2,7,1,57,5,599,437,700,0,263,437,700,0,0,425,7,5,437,0,1808,1900,False,232,193,sebsi:1  marzouki:1  
2,7,1,57,4,599,466,696,1,229,466,696,0,0,459,6,1,466,0,1800,1935,False,275,184,sebsi:1  marzouki:1  
2,7,1,57,3,599,492,700,1,207,492,700,0,0,478,9,5,492,0,1815,1930,True,282,196,sebsi:1  marzouki:1  
2,7,1,57,2,599,461,700,1,238,461,700,0,0,449,8,4,461,0,1820,1920,True,306,143,sebsi:1  marzouki:1  
2,7,1,57,1,599,494,700,4,202,494,700,0,0,487,4,3,494,0,1830,1958,True,345,142,sebsi:1  marzouki:1  
2,7,1,56,9,586,287,700,0,413,287,700,0,0,271,9,7,287,0,1815,1900,True,166,105,sebsi:1  marzouki:1  
2,7,1,56,8,589,389,700,0,311,389,700,0,0,374,6,9,389,0,1830,1930,True,260,114,sebsi:1  marzouki:1  
2,7,1,56,7,589,382,700,2,316,382,700,0,0,374,7,1,382,0,1810,1915,False,219,155,sebsi:1  marzouki:1  
2,7,1,56,6,589,397,700,0,303,397,700,0,0,383,9,5,397,0,1845,1935,False,225,158,sebsi:1  marzouki:1  
2,7,1,56,5,589,457,683,4,222,457,683,0,0,442,10,5,457,0,1820,2011,False,302,140,sebsi:1  marzouki:1  
2,7,1,56,4,589,449,700,1,250,449,700,0,0,440,4,5,449,0,1910,2030,True,299,141,sebsi:1  marzouki:1  
2,7,1,56,3,589,486,700,1,213,486,700,0,0,480,5,1,486,0,1815,1920,False,339,141,sebsi:1  marzouki:1  
2,7,1,56,2,589,477,700,3,220,477,700,0,0,470,4,3,477,0,1830,2033,False,361,109,sebsi:1  marzouki:1  
2,7,1,56,1,589,487,700,1,213,486,700,0,1,472,11,3,486,0,1830,2000,False,370,102,sebsi:1  marzouki:1  
2,5,7,46,7,573,255,700,0,445,255,700,0,0,245,4,6,255,0,1830,1930,False,159,86,sebsi:1  marzouki:1  
2,5,7,46,6,578,318,700,0,382,318,700,0,0,311,5,2,318,0,1800,1915,True,208,103,sebsi:1  marzouki:1  
2,5,7,46,5,578,321,696,1,374,321,696,0,0,314,3,4,321,0,1815,,True,217,97,sebsi:1  marzouki:1  
2,5,7,46,4,578,375,696,0,321,375,696,0,0,366,8,1,375,0,1830,1915,True,248,118,sebsi:1  marzouki:1  
2,5,7,46,3,578,375,700,3,322,375,700,0,0,360,15,0,375,0,1810,1915,True,242,118,sebsi:1  marzouki:1  
2,5,7,46,2,578,397,700,1,302,397,700,0,0,383,13,1,397,0,1810,1920,False,274,109,sebsi:1  marzouki:1  
2,5,7,46,1,578,422,700,1,279,421,701,1,1,415,4,2,421,0,1815,1920,False,292,123,sebsi:1  marzouki:1  
2,5,6,45,3,572,310,708,0,398,310,708,0,0,302,5,3,310,0,1815,1902,False,209,93,sebsi:1  marzouki:1  
2,5,6,45,2,574,317,700,0,383,317,700,0,0,311,5,1,317,0,1834,1900,True,209,102,sebsi:1  marzouki:1  
2,5,6,45,1,574,403,700,3,294,403,700,0,0,390,6,7,403,0,1830,1920,False,290,100,sebsi:1  marzouki:1  
2,5,6,44,8,543,304,600,0,296,304,600,0,0,298,3,3,304,0,1815,1915,False,200,98,sebsi:1  marzouki:1  
2,5,6,44,7,545,362,600,0,238,362,600,0,0,350,5,7,362,0,1820,1918,True,220,130,sebsi:1  marzouki:1  
2,5,6,44,6,545,395,600,1,204,395,600,0,0,390,2,3,395,0,1800,1910,True,252,138,sebsi:1  marzouki:1  
2,5,6,44,5,545,434,601,0,167,434,601,0,0,430,3,1,434,0,1800,1915,False,241,189,sebsi:1  marzouki:1  
2,5,6,44,4,545,403,600,0,197,403,600,0,0,400,1,2,403,0,1803,1920,True,272,128,sebsi:1  marzouki:1  
2,5,6,44,3,545,421,600,1,178,421,600,0,0,414,4,3,421,0,1822,1929,True,294,120,sebsi:1  marzouki:1  
2,5,6,44,2,545,452,592,1,139,452,592,0,0,444,8,0,452,0,1820,1935,True,283,161,sebsi:1  marzouki:1  
2,5,6,44,1,545,458,595,2,135,458,595,0,0,444,10,4,458,0,1800,1940,False,309,135,sebsi:1  marzouki:1  
2,5,5,43,3,476,322,596,1,273,322,596,0,0,312,6,4,322,0,1815,1910,False,201,111,sebsi:1  marzouki:1  
2,5,5,43,2,477,347,600,0,253,347,600,0,0,341,2,4,347,0,1810,1910,True,223,118,sebsi:1  marzouki:1  
2,5,5,43,1,477,389,600,0,211,389,600,0,0,371,15,3,389,0,1810,1905,False,273,98,sebsi:1  marzouki:1  
2,5,5,42,6,570,305,700,2,393,305,700,0,0,296,4,5,305,0,1815,1912,True,203,93,sebsi:1  marzouki:1  
2,5,5,42,5,572,354,700,2,344,354,700,0,0,341,7,6,354,0,1815,1915,False,238,103,sebsi:1  marzouki:1  
2,5,5,42,4,572,434,702,0,268,434,702,0,0,428,4,2,434,0,1810,1930,True,284,144,sebsi:1  marzouki:1  
2,5,5,42,3,572,402,700,2,296,402,700,0,0,389,10,3,402,0,,1911,False,314,75,sebsi:1  marzouki:1  
2,5,5,42,2,572,446,699,0,253,446,699,0,0,435,8,3,446,0,1840,1952,True,338,97,sebsi:1  marzouki:1  
2,5,5,42,1,572,459,700,0,241,459,700,0,0,336,16,7,459,0,,1930,False,335,101,sebsi:1  marzouki:1  
2,5,4,41,2,534,322,600,0,278,322,600,0,0,311,5,6,322,0,1830,1905,True,243,68,sebsi:1  marzouki:1  
2,5,4,41,1,534,396,602,0,206,396,602,0,0,374,20,2,396,0,1830,1955,True,305,69,sebsi:1  marzouki:1  
2,5,4,40,7,529,281,600,0,319,281,600,0,0,274,5,2,281,0,1815,1855,False,192,82,sebsi:1  marzouki:1  
2,5,4,40,6,533,323,600,2,275,323,600,0,0,316,5,2,323,0,1830,1911,True,218,98,sebsi:1  marzouki:1  
2,5,4,40,5,533,344,600,0,256,344,600,0,0,330,4,10,344,0,1810,1900,False,245,85,sebsi:1  marzouki:1  
2,5,4,40,4,533,357,595,0,238,357,595,0,0,350,6,1,357,0,1800,1930,False,247,103,sebsi:1  marzouki:1  
2,5,4,40,3,533,388,600,0,212,388,600,0,0,370,11,7,388,0,1815,,False,266,104,sebsi:1  marzouki:1  
2,5,4,40,2,533,416,596,3,177,416,596,0,0,400,8,8,416,0,1800,1930,True,307,93,sebsi:1  marzouki:1  
2,5,4,40,1,533,417,600,1,182,417,600,0,0,399,17,1,417,0,1820,1930,False,309,90,sebsi:1  marzouki:1  
2,5,3,39,5,576,282,700,1,417,282,700,0,0,272,8,2,282,0,1830,1937,True,183,89,sebsi:1  marzouki:1  
2,5,3,39,4,580,314,700,0,386,314,700,0,0,307,2,5,314,0,1829,1914,True,241,66,sebsi:1  marzouki:1  
2,5,3,39,3,580,385,700,0,315,385,700,0,0,380,4,1,385,0,1815,1920,False,294,86,sebsi:1  marzouki:1  
2,5,3,38,7,583,359,700,1,340,359,700,0,0,355,2,2,359,0,1840,1946,False,267,88,sebsi:1  marzouki:1  
2,5,3,38,5,584,438,700,0,262,438,700,0,0,432,4,2,438,0,1810,1920,True,316,116,sebsi:1  marzouki:1  
2,5,3,38,4,584,409,700,0,291,409,700,0,0,398,4,7,409,0,1830,1930,False,294,104,sebsi:1  marzouki:1  
2,5,3,38,3,584,483,700,1,216,483,700,0,0,469,9,5,483,0,1810,1920,False,367,102,sebsi:1  marzouki:1  
2,5,3,38,1,584,467,700,0,233,467,700,0,0,451,9,7,467,0,1820,2016,False,383,68,sebsi:1  marzouki:1  
2,5,2,37,6,575,324,696,0,372,324,696,0,0,314,9,1,324,0,1900,2010,True,226,88,sebsi:1  marzouki:1  
2,5,2,37,5,580,362,696,0,334,362,696,0,0,356,3,3,362,0,1825,1913,True,272,84,sebsi:1  marzouki:1  
2,5,2,37,4,580,436,700,1,263,436,700,0,0,434,2,0,436,0,1825,1930,False,322,112,sebsi:1  marzouki:1  
2,5,2,37,3,580,401,700,1,299,400,700,0,1,390,4,6,400,0,1845,2000,False,278,112,sebsi:1  marzouki:1  
2,5,2,37,2,580,455,700,0,245,455,700,0,0,447,5,3,455,0,1814,1930,True,344,103,sebsi:1  marzouki:1  
2,5,2,37,1,580,450,702,1,251,450,702,0,0,435,13,2,450,0,1825,1940,False,353,82,sebsi:1  marzouki:1  
2,5,1,36,4,554,327,600,0,273,327,600,0,0,320,1,6,327,0,1820,1930,True,264,56,sebsi:1  marzouki:1  
2,5,1,36,3,555,361,600,1,238,361,600,0,0,354,5,2,361,0,1820,1925,False,299,55,sebsi:1  marzouki:1  
2,5,1,36,1,555,426,600,1,173,426,600,0,0,420,5,1,426,0,1830,1940,False,358,62,sebsi:1  marzouki:1  
2,5,1,35,6,595,402,701,1,298,402,701,0,0,393,5,4,402,0,1830,1950,False,327,66,sebsi:1  marzouki:1  
2,5,1,35,5,595,418,700,1,282,417,700,0,1,408,5,4,417,0,1830,2050,False,323,85,sebsi:1  marzouki:1  
2,5,1,35,4,595,450,700,0,250,450,700,0,0,444,5,1,450,0,1830,1925,False,363,81,sebsi:1  marzouki:1  
2,5,1,35,3,595,463,700,1,236,463,700,0,0,451,9,3,463,0,1827,1927,True,362,89,sebsi:1  marzouki:1  
2,5,1,35,1,595,449,725,2,274,449,725,0,0,433,13,3,449,0,1815,1930,False,366,67,sebsi:1  marzouki:1  
2,5,1,34,7,587,395,707,0,312,395,707,0,0,389,4,2,395,0,1806,1909,True,332,57,sebsi:1  marzouki:1  
2,5,1,34,6,589,434,700,0,266,434,700,0,0,415,11,8,434,0,1814,1923,False,328,87,sebsi:1  marzouki:1  
2,5,1,34,5,589,485,700,0,215,485,700,0,0,475,4,6,485,0,1825,1925,False,390,85,sebsi:1  marzouki:1  
2,5,1,34,4,589,472,700,1,227,472,700,0,0,464,8,0,472,0,1825,1930,False,386,78,sebsi:1  marzouki:1  
2,5,1,34,3,589,502,700,1,197,502,700,0,0,496,4,2,502,0,1830,1952,True,435,61,sebsi:1  marzouki:1  
2,5,1,34,2,589,498,700,2,201,497,700,0,1,487,6,4,497,0,1832,2007,False,414,73,sebsi:1  marzouki:1  
2,5,1,34,1,589,494,700,2,204,494,700,0,0,490,2,2,494,0,1835,1935,True,412,78,sebsi:1  marzouki:1  
2,5,1,33,8,572,421,702,0,281,421,702,0,0,413,3,5,421,0,1815,1914,True,348,65,sebsi:1  marzouki:1  
2,5,1,33,7,572,419,700,1,280,419,700,0,0,403,11,5,419,0,,1845,False,344,59,sebsi:1  marzouki:1  
2,5,1,33,6,572,474,700,2,224,474,700,0,0,461,8,5,474,0,1805,1905,False,410,51,sebsi:1  marzouki:1  
2,5,1,33,5,572,468,700,0,232,468,700,0,0,461,6,1,468,0,1818,1930,False,394,67,sebsi:1  marzouki:1  
2,5,1,33,4,572,493,700,1,206,493,700,0,0,489,4,0,493,0,1820,1930,False,419,70,sebsi:1  marzouki:1  
2,5,1,33,3,572,510,700,1,189,510,700,0,0,501,7,2,510,0,1800,2000,True,444,57,sebsi:1  marzouki:1  
2,5,1,33,2,572,503,700,0,197,503,700,0,0,497,5,1,503,0,,1930,False,441,56,sebsi:1  marzouki:1  
2,5,1,33,1,572,498,700,1,201,498,700,0,0,486,7,5,498,0,1820,1930,False,436,50,sebsi:1  marzouki:1  
2,5,1,32,9,534,383,596,0,213,383,596,0,0,376,5,2,383,0,1815,1940,True,326,50,sebsi:1  marzouki:1  
2,5,1,32,8,542,424,588,1,163,424,588,0,0,412,7,5,424,0,1812,1914,True,336,76,sebsi:1  marzouki:1  
2,5,1,32,7,542,426,596,0,170,426,596,0,0,419,4,3,426,0,1810,1900,True,362,57,sebsi:1  marzouki:1  
2,5,1,32,6,542,470,601,0,131,470,601,0,0,467,1,2,470,0,1823,1928,True,400,67,sebsi:1  marzouki:1  
2,5,1,32,5,542,449,600,1,150,449,600,0,0,439,4,6,449,0,1800,1930,False,366,73,sebsi:1  marzouki:1  
2,5,1,32,4,542,476,591,1,114,476,591,0,0,470,2,4,476,0,1820,1925,True,409,61,sebsi:1  marzouki:1  
2,5,1,32,3,542,460,600,3,137,460,600,0,0,453,5,2,460,0,,1919,True,363,90,sebsi:1  marzouki:1  
2,5,1,32,1,542,475,596,1,120,475,596,0,0,472,1,2,475,0,1825,1922,False,411,61,sebsi:  marzouki:  
2,8,3,75,3,402,282,500,0,218,282,500,0,0,273,5,4,282,0,1836,1930,True,193,80,sebsi:1  marzouki:1  
2,8,3,75,2,403,271,500,0,229,271,500,0,0,266,3,2,271,0,1814,1902,False,194,72,sebsi:1  marzouki:1  
2,8,3,75,1,403,311,499,0,188,311,499,0,0,307,3,1,311,0,1825,1930,False,253,54,sebsi:1  marzouki:1  
2,8,3,74,7,541,311,596,0,285,311,596,0,0,307,4,0,311,0,1825,1910,False,189,118,sebsi:1  marzouki:1  
2,8,3,74,6,545,283,600,1,316,283,600,0,0,277,5,1,283,0,1815,1930,False,164,113,sebsi:1  marzouki:1  
2,8,3,74,5,545,337,600,1,263,337,601,1,0,330,3,4,337,0,1840,1945,False,211,119,sebsi:1  marzouki:1  
2,8,3,74,4,545,362,600,1,237,362,600,0,0,355,4,3,362,0,1835,1910,False,223,132,sebsi:1  marzouki:1  
2,8,3,74,3,545,361,603,0,242,361,603,0,0,351,1,9,361,0,1819,1900,False,224,127,sebsi:1  marzouki:1  
2,8,3,74,1,545,407,595,0,188,407,595,0,0,394,11,2,407,0,1810,1900,False,274,120,sebsi:1  marzouki:1  
2,8,3,73,8,584,376,700,0,324,376,700,0,0,366,7,3,376,0,,1915,False,240,126,sebsi:1  marzouki:1  
2,8,3,73,6,591,397,700,0,303,397,700,0,0,387,1,9,397,0,1810,1910,False,243,144,sebsi:1  marzouki:1  
2,8,3,73,5,591,460,700,0,240,460,700,0,0,449,8,3,460,0,1815,1920,False,294,155,sebsi:1  marzouki:1  
2,8,3,73,4,591,445,701,0,256,445,701,0,0,438,3,4,445,0,1800,1845,True,293,145,sebsi:1  marzouki:1  
2,8,3,73,3,591,457,700,1,242,457,700,0,0,450,1,6,457,0,1825,1925,False,316,134,sebsi:1  marzouki:1  
2,8,3,73,2,591,473,700,5,222,473,700,0,0,455,14,4,473,0,1805,,False,334,121,sebsi:1  marzouki:1  
2,8,3,73,1,591,481,700,0,219,481,700,0,0,469,10,2,481,0,1810,1925,False,347,122,sebsi:1  marzouki:1  
2,8,3,72,8,544,382,600,0,218,382,600,0,0,366,6,10,382,0,1800,1920,True,263,103,sebsi:1  marzouki:1  
2,8,3,72,7,545,390,598,0,208,390,598,0,0,382,5,3,390,0,1800,1915,False,283,99,sebsi:1  marzouki:1  
2,8,3,72,6,545,421,601,0,180,421,601,0,0,406,6,9,421,0,1810,1920,False,278,128,sebsi:1  marzouki:1  
2,8,3,72,5,545,430,600,0,170,430,600,0,0,418,5,7,430,0,1800,1930,False,288,130,sebsi:1  marzouki:1  
2,8,3,72,4,545,452,600,0,148,452,600,0,0,445,2,5,452,0,1818,1925,True,344,101,sebsi:1  marzouki:1  
2,8,3,72,3,545,461,600,1,138,461,600,0,0,455,5,1,461,0,1820,1920,False,307,148,sebsi:1  marzouki:1  
2,8,3,72,2,545,484,599,1,114,484,599,0,0,470,8,6,484,0,1820,1945,True,365,105,sebsi:1  marzouki:1  
2,8,3,72,1,545,453,600,0,147,453,600,0,0,444,7,2,453,0,1800,2010,False,338,106,sebsi:1  marzouki:1  
2,8,2,71,7,569,366,700,0,334,366,700,0,0,361,0,5,366,0,1815,1905,True,262,99,sebsi:1  marzouki:1  
2,8,2,71,6,572,396,701,5,301,395,701,0,1,389,4,2,395,0,1830,2030,True,310,79,sebsi:1  marzouki:1  
2,8,2,71,5,572,433,700,0,267,433,700,0,0,427,3,3,433,0,1800,1915,True,321,106,sebsi:1  marzouki:1  
2,8,2,71,4,572,439,700,0,261,439,700,0,0,437,1,1,439,0,1820,1900,False,308,129,sebsi:1  marzouki:1  
2,8,2,71,3,572,462,700,2,236,462,700,0,0,454,7,1,462,0,1813,1915,False,383,71,sebsi:1  marzouki:1  
2,8,2,71,2,572,438,700,0,262,438,700,0,0,426,11,1,438,0,1815,1910,True,331,95,sebsi:1  marzouki:1  
2,8,2,71,1,572,456,700,1,243,456,700,0,0,436,16,4,456,0,1820,1930,False,372,64,sebsi:1  marzouki:1  
2,8,1,70,8,573,363,700,0,337,363,700,0,0,357,5,1,363,0,1830,1858,True,260,97,sebsi:1  marzouki:1  
2,8,1,70,7,575,387,700,0,313,387,700,0,0,375,9,3,387,0,1815,1920,True,286,89,sebsi:1  marzouki:1  
2,8,1,70,6,575,406,703,0,297,406,703,0,0,404,0,2,406,0,1834,1921,True,312,92,sebsi:1  marzouki:1  
2,8,1,70,5,575,442,698,1,255,442,698,0,0,436,5,1,442,0,1818,1940,True,327,109,sebsi:1  marzouki:1  
2,8,1,70,4,575,437,705,1,267,437,705,0,0,432,4,1,437,0,1830,2000,True,348,84,sebsi:1  marzouki:1  
2,8,1,70,3,575,469,700,3,228,469,700,0,0,453,11,5,469,0,1825,1920,True,350,103,sebsi:1  marzouki:1  
2,8,1,70,2,575,462,701,2,237,462,701,0,0,452,8,2,462,0,1925,2030,True,375,77,sebsi:1  marzouki:1  
2,8,1,70,1,575,445,691,1,245,445,691,0,0,426,14,5,445,0,1800,2005,False,355,71,sebsi:1  marzouki:1  
2,4,6,31,5,590,339,700,0,361,339,700,0,0,333,5,1,339,0,1830,1930,True,197,136,sebsi:  marzouki:  
2,4,6,31,4,592,408,700,1,291,408,700,0,0,403,4,1,408,0,1840,2000,True,238,165,sebsi:  marzouki:  
2,4,6,31,3,592,444,684,1,239,444,684,0,0,437,4,3,444,0,1830,1930,True,285,152,sebsi:1  marzouki:1  
2,4,6,31,1,592,470,700,1,229,470,700,0,0,439,28,3,470,0,1800,2040,True,316,123,sebsi:1  marzouki:1  
2,4,5,30,7,547,251,600,0,349,251,600,0,0,249,1,1,251,0,1835,1930,True,154,95,sebsi:1  marzouki:1  
2,4,5,30,6,549,283,600,0,317,283,600,0,0,271,7,5,283,0,1800,1923,False,169,102,sebsi:1  marzouki:1  
2,4,5,30,5,549,302,600,0,298,302,600,0,0,296,1,5,302,0,1805,1935,False,188,108,sebsi:1  marzouki:1  
2,4,5,30,4,549,362,600,0,238,362,600,0,0,346,8,8,362,0,1807,1908,True,210,136,sebsi:1  marzouki:1  
2,4,5,30,3,549,373,596,1,221,373,595,1,0,358,14,1,373,0,1812,1920,True,245,113,sebsi:1  marzouki:1  
2,4,5,30,2,549,417,600,0,183,417,600,0,0,400,11,6,417,0,1800,1926,True,277,123,sebsi:1  marzouki:1  
2,4,5,30,1,549,402,600,1,195,404,600,0,2,379,21,5,405,1,1830,1930,True,284,95,sebsi:1  marzouki:1  
2,4,4,29,5,545,322,600,3,275,322,600,0,0,316,2,4,322,0,1815,1939,False,216,100,sebsi:1  marzouki:1  
2,4,4,29,4,548,363,601,0,238,363,601,0,0,355,3,5,363,0,1815,2000,False,235,120,sebsi:1  marzouki:1  
2,4,4,29,3,548,394,599,0,205,394,599,0,0,384,5,5,394,0,1815,1950,False,265,119,sebsi:1  marzouki:1  
2,4,4,29,2,548,410,600,9,181,410,600,0,0,397,9,4,410,0,1830,1915,False,288,109,sebsi:1  marzouki:1  
2,4,3,28,8,534,361,600,1,238,361,600,0,0,350,4,7,361,0,1820,1915,True,246,104,sebsi:1  marzouki:1  
2,4,3,28,7,539,381,596,0,215,381,596,0,0,375,3,3,381,0,1800,,False,263,112,sebsi:1  marzouki:1  
2,4,3,28,6,539,363,600,0,237,363,600,0,0,357,6,0,363,0,,1930,True,215,142,sebsi:1  marzouki:1  
2,4,3,28,5,539,401,600,0,199,401,600,0,0,397,4,0,401,0,1820,1915,True,242,155,sebsi:1  marzouki:1  
2,4,3,28,4,539,438,600,0,162,438,600,0,0,430,3,5,438,0,,1915,True,302,128,sebsi:1  marzouki:1  
2,4,3,28,3,539,415,600,0,185,415,600,0,0,412,1,2,415,0,,1910,True,297,115,sebsi:1  marzouki:1  
2,4,3,28,2,539,445,600,0,155,445,600,0,0,434,7,4,445,0,1825,1910,True,324,110,sebsi:1  marzouki:1  
2,4,3,28,1,539,431,600,3,166,431,600,0,0,420,9,2,431,0,1825,,True,307,113,sebsi:1  marzouki:1  
2,4,2,27,6,538,297,603,1,305,297,603,0,0,295,1,1,297,0,1830,1935,True,164,131,sebsi:1  marzouki:1  
2,4,2,27,5,542,319,596,0,277,319,596,0,0,311,5,3,319,0,1844,1935,True,154,157,sebsi:1  marzouki:1  
2,4,2,27,4,542,354,598,0,244,354,598,0,0,351,1,2,354,0,1825,1919,True,193,158,sebsi:1  marzouki:1  
2,4,2,27,3,542,368,603,1,234,368,603,0,0,340,20,8,368,0,1800,1945,False,201,139,sebsi:1  marzouki:1  
2,4,2,27,2,542,397,600,0,203,397,600,0,0,387,6,4,397,0,1830,2000,True,250,137,sebsi:1  marzouki:1  
2,4,2,27,1,542,390,600,3,208,389,600,0,1,375,11,3,389,0,1830,2015,True,260,115,sebsi:1  marzouki:1  
2,4,2,26,6,575,343,700,0,357,343,700,0,0,335,6,2,343,0,1818,1925,False,204,131,sebsi:1  marzouki:1  
2,4,2,26,5,580,340,700,0,360,340,700,0,0,329,9,2,340,0,1800,1926,True,190,139,sebsi:1  marzouki:1  
2,4,2,26,4,580,411,700,2,287,411,700,0,0,401,7,3,411,0,1830,1930,False,240,161,sebsi:1  marzouki:1  
2,4,2,26,3,580,416,700,2,282,416,700,0,0,402,13,1,416,0,1816,1930,False,278,124,sebsi:1  marzouki:1  
2,4,2,26,2,580,444,700,0,256,444,700,0,0,429,9,6,444,0,1805,1915,True,280,149,sebsi:1  marzouki:1  
2,4,2,26,1,580,431,700,0,269,431,700,0,0,420,9,2,431,0,1815,1940,False,303,117,sebsi:1  marzouki:1  
2,4,1,25,8,544,357,600,0,243,357,600,0,0,346,5,6,357,0,1820,1913,True,198,148,sebsi:1  marzouki:1  
2,4,1,25,7,546,396,600,4,200,396,600,0,0,382,8,6,396,0,1820,1915,False,262,120,sebsi:1  marzouki:1  
2,4,1,25,6,546,429,597,0,168,429,597,0,0,423,5,1,429,0,,1910,False,300,123,sebsi:1  marzouki:1  
2,4,1,25,5,546,462,600,0,138,462,600,0,0,451,5,6,462,0,1820,1925,False,290,161,sebsi:1  marzouki:1  
2,4,1,25,4,546,446,600,0,155,445,600,0,1,437,7,1,445,0,1812,,False,308,129,sebsi:1  marzouki:1  
2,4,1,25,3,546,474,600,1,125,474,600,0,0,464,9,1,474,0,,1850,True,345,119,sebsi:1  marzouki:1  
2,4,1,25,2,546,450,600,1,149,450,600,0,0,442,7,1,450,0,1805,1915,True,331,111,sebsi:1  marzouki:1  
2,4,1,25,1,546,466,601,1,134,466,601,0,0,453,6,7,466,0,,1920,False,377,76,sebsi:1  marzouki:1  
2,4,1,24,7,567,348,603,0,255,348,603,0,0,339,5,4,348,0,1810,1847,True,230,109,sebsi:1  marzouki:1  
2,4,1,24,6,567,364,599,0,235,364,599,0,0,351,7,6,364,0,1830,1915,True,277,74,sebsi:1  marzouki:1  
2,4,1,24,5,567,392,600,0,208,392,600,0,0,384,3,5,392,0,1810,1930,True,287,97,sebsi:1  marzouki:1  
2,4,1,24,4,567,431,598,0,167,431,598,0,0,425,3,3,431,0,1815,1945,True,320,105,sebsi:1  marzouki:1  
2,4,1,24,3,567,447,600,0,153,447,600,0,0,441,2,4,447,0,1820,1930,True,354,87,sebsi:1  marzouki:1  
2,4,1,24,2,567,442,600,1,157,442,600,0,0,432,6,4,442,0,1830,1940,False,346,86,sebsi:1  marzouki:1  
2,4,1,24,1,567,422,600,1,178,421,600,0,1,413,7,1,421,0,1825,1920,True,361,52,sebsi:1  marzouki:1  
2,1,3,4,4,487,314,600,0,286,314,600,0,0,305,5,4,314,0,1805,1902,True,143,162,sebsi:1  marzouki:1  
2,1,3,4,3,487,337,600,1,262,337,600,0,0,331,3,3,337,0,1830,1905,True,174,157,sebsi:1  marzouki:1  
2,1,3,4,2,487,360,600,0,240,360,600,0,0,357,2,1,360,0,1800,1915,True,204,153,sebsi:1  marzouki:1  
2,1,3,4,1,487,377,600,0,224,376,0,0,1,369,5,2,376,0,1805,1900,False,231,138,sebsi:1  marzouki:1  
2,1,2,3,4,475,314,600,0,286,314,600,0,0,299,8,7,314,0,1820,,True,132,167,sebsi:1  marzouki:1  
2,1,2,3,3,478,352,600,1,249,350,600,0,2,345,2,3,350,0,1819,1935,True,185,160,sebsi:1  marzouki:1  
2,1,2,3,2,478,373,600,0,227,373,600,0,0,367,4,2,373,0,1810,2000,True,198,169,sebsi:1  marzouki:1  
2,1,2,3,1,478,378,602,1,223,378,602,0,0,374,1,3,378,0,1813,1921,False,214,160,sebsi:1  marzouki:1  
2,1,1,2,6,552,358,600,0,242,358,600,0,0,351,6,1,358,0,1820,1915,False,186,165,sebsi:1  marzouki:1  
2,1,1,2,5,554,359,600,0,242,358,600,0,1,351,4,3,358,0,0800,1905,True,176,175,sebsi:1  marzouki:1  
2,1,1,2,4,554,392,601,0,209,392,601,0,0,388,2,2,392,0,1830,2000,True,196,192,sebsi:1  marzouki:1  
2,1,1,2,3,554,417,600,1,182,417,600,0,0,409,3,5,417,0,1835,1950,False,209,200,sebsi:1  marzouki:1  
2,1,1,2,2,554,430,600,0,170,430,600,0,0,417,10,3,430,0,1830,1939,False,263,154,sebsi:1  marzouki:1  
2,1,1,2,1,554,429,600,0,171,429,600,0,0,418,8,3,429,0,,1928,False,276,142,sebsi:1  marzouki:1  
2,1,1,1,8,577,361,700,0,339,361,700,0,0,350,7,4,361,0,,1812,False,169,181,sebsi:1  marzouki:1  
2,1,1,1,7,578,358,696,0,338,358,696,0,0,350,4,4,358,0,1900,1930,True,204,146,sebsi:1  marzouki:1  
2,1,1,1,6,578,363,700,0,337,363,700,0,0,356,2,5,363,0,1830,1930,False,164,192,sebsi:1  marzouki:1  
2,1,1,1,5,578,413,700,1,286,413,700,0,0,408,4,1,413,0,1805,1916,True,220,188,sebsi:1  marzouki:1  
2,1,1,1,4,578,442,700,0,258,442,700,0,0,434,7,1,442,0,,1930,True,260,174,sebsi:1  marzouki:1  
2,1,1,1,3,578,429,700,0,271,429,700,0,0,422,5,2,429,0,1825,1930,False,253,169,sebsi:1  marzouki:1  
2,1,1,1,2,578,419,700,2,279,419,700,0,0,410,6,3,419,0,1800,1940,True,267,143,sebsi:1  marzouki:1  
2,1,1,1,1,578,460,699,0,239,460,699,0,0,444,9,7,460,0,1830,1935,False,296,148,sebsi:1  marzouki:1  
2,3,6,23,3,455,226,509,0,283,226,509,0,0,219,5,2,226,0,1815,1930,True,110,109,sebsi:1  marzouki:1  
2,3,6,23,2,457,284,500,1,215,284,500,0,0,281,1,2,284,0,1830,1920,True,146,135,sebsi:1  marzouki:1  
2,3,5,22,1,558,343,600,0,257,343,600,0,0,337,1,5,343,0,1830,1930,True,193,144,sebsi:1  marzouki:1  
2,3,4,21,7,575,288,700,1,411,288,700,0,0,281,6,1,288,0,1805,1855,True,145,136,sebsi:1  marzouki:1  
2,3,4,21,6,578,296,700,0,404,296,700,0,0,290,5,1,296,0,1830,1920,True,150,140,sebsi:1  marzouki:1  
2,3,4,21,5,578,299,700,1,400,299,700,0,0,292,3,4,299,0,1815,1905,True,141,151,sebsi:1  marzouki:1  
2,3,4,21,4,578,351,703,1,351,351,703,0,0,342,4,5,351,0,1825,1922,True,175,167,sebsi:1  marzouki:1  
2,3,4,21,3,578,375,700,0,325,375,700,0,0,363,12,0,375,0,1815,1915,True,213,150,sebsi:1  marzouki:1  
2,3,4,21,2,578,412,700,2,286,412,700,0,0,406,5,1,412,0,1830,2015,True,242,164,sebsi:  marzouki:  
2,3,4,21,1,578,416,700,5,279,416,700,0,0,404,9,3,416,0,,2000,True,253,151,sebsi:  marzouki:  
2,3,4,20,8,531,263,600,0,337,263,600,0,0,245,14,4,263,0,1825,1930,True,127,118,sebsi:  marzouki:  
2,3,4,20,7,532,351,599,0,248,351,599,0,0,330,14,7,351,0,,1930,True,182,148,sebsi:  marzouki:  
2,3,4,20,6,532,321,600,0,279,321,600,0,0,316,1,4,321,0,1825,1910,True,165,151,sebsi:  marzouki:  
2,3,4,20,4,532,392,597,0,205,392,597,0,0,385,5,2,392,0,1810,1850,True,208,177,sebsi:  marzouki:  
2,3,4,20,3,532,430,600,0,173,430,603,3,0,420,5,5,430,0,1815,1930,True,237,183,sebsi:  marzouki:  
2,3,4,20,2,532,411,600,0,189,411,600,0,0,404,2,5,411,0,1815,1910,True,259,145,sebsi:  marzouki:  
2,3,4,20,1,532,432,600,2,166,432,600,0,0,416,15,1,432,0,1830,1944,False,257,159,sebsi:  marzouki:  
2,3,3,19,8,540,312,599,0,287,312,599,0,0,304,4,4,312,0,,1900,True,143,161,sebsi:  marzouki:  
2,3,3,19,7,543,334,600,0,266,334,600,0,0,330,2,2,334,0,1800,1900,False,149,181,sebsi:  marzouki:  
2,3,3,19,6,543,263,600,0,337,263,600,0,0,256,4,3,263,0,1800,1925,True,118,138,sebsi:  marzouki:  
2,3,3,19,5,543,348,600,0,252,348,600,0,0,337,7,4,348,0,1815,1900,True,150,187,sebsi:  marzouki:  
2,3,3,19,4,543,352,600,0,248,352,600,0,0,352,3,3,358,6,1800,1910,False,184,161,sebsi:  marzouki:  
2,3,3,19,2,543,401,600,0,199,401,600,0,0,389,10,2,401,0,1815,2007,True,253,136,sebsi:  marzouki:  
2,3,3,19,1,543,408,600,2,190,408,600,0,0,390,15,3,408,0,1800,,False,246,144,sebsi:  marzouki:  
2,3,3,18,4,542,311,600,1,288,311,600,0,0,298,7,6,311,0,1820,1900,True,148,150,sebsi:  marzouki:  
2,3,3,18,3,542,374,600,3,223,374,600,0,0,368,3,3,374,0,1815,1904,False,187,181,sebsi:  marzouki:  
2,3,3,18,2,542,409,600,0,191,409,600,0,0,401,1,7,409,0,1830,1900,True,215,186,sebsi:  marzouki:  
2,3,3,18,1,542,410,607,0,197,410,607,0,0,404,3,3,410,0,1800,1910,True,263,141,sebsi:1  marzouki:1  
2,3,2,17,7,522,290,600,1,309,290,600,0,0,281,4,5,290,0,1815,1915,True,128,153,sebsi:1  marzouki:1  
2,3,2,17,6,527,324,596,1,272,323,596,0,1,315,1,7,323,0,1820,1930,True,150,165,sebsi:1  marzouki:1  
2,3,2,17,5,527,316,600,0,284,316,600,0,0,312,3,1,316,0,1815,1905,False,146,166,sebsi:1  marzouki:1  
2,3,2,17,4,527,342,606,0,264,342,606,0,0,336,6,0,342,0,1815,1900,True,192,144,sebsi:1  marzouki:1  
2,3,2,17,3,527,371,600,2,227,371,600,0,0,366,4,1,371,0,1815,1915,False,228,138,sebsi:1  marzouki:1  
2,3,2,17,2,527,379,588,0,210,378,588,0,1,364,13,1,378,0,1815,1900,True,244,120,sebsi:1  marzouki:1  
2,3,2,17,1,527,398,600,1,201,398,600,0,0,377,18,3,398,0,1820,2006,False,252,125,sebsi:1  marzouki:1  
2,3,1,16,7,577,322,700,0,378,322,700,0,0,311,7,4,322,0,1820,1916,True,169,142,sebsi:1  marzouki:1  
2,3,1,16,6,583,357,700,0,343,357,700,0,0,350,6,1,357,0,1815,1905,True,185,165,sebsi:1  marzouki:1  
2,3,1,16,5,583,368,700,0,332,368,700,0,0,362,3,3,368,0,1815,1915,True,168,194,sebsi:1  marzouki:1  
2,3,1,16,4,583,400,700,0,300,400,700,0,0,395,1,4,400,0,1825,1945,True,203,192,sebsi:1  marzouki:1  
2,3,1,16,2,583,392,700,0,308,392,700,0,0,372,10,10,392,0,1820,1920,False,243,129,sebsi:1  marzouki:1  
2,3,1,15,8,546,342,600,0,258,342,600,0,0,326,16,0,342,0,1830,1915,True,163,163,sebsi:1  marzouki:1  
2,3,1,15,6,548,364,600,1,236,363,600,0,1,356,3,4,363,0,1830,2001,True,164,192,sebsi:1  marzouki:1  
2,3,1,15,5,548,396,600,0,204,396,600,0,0,394,2,0,396,0,1805,1900,True,205,189,sebsi:1  marzouki:1  
2,3,1,15,4,548,393,600,0,207,393,600,0,0,384,5,4,393,0,1820,1936,False,205,179,sebsi:1  marzouki:1  
2,3,1,15,3,548,404,600,2,194,404,600,0,0,392,10,2,404,0,1805,1930,True,238,154,sebsi:1  marzouki:1  
2,3,1,15,2,548,411,600,0,189,411,600,0,0,387,21,3,411,0,1815,2000,True,252,135,sebsi:1  marzouki:1  
2,3,1,15,1,548,427,600,0,173,427,600,0,0,417,5,5,427,0,1820,1905,True,266,151,sebsi:1  marzouki:1  
2,2,5,14,3,430,233,500,0,267,233,500,0,0,225,5,3,233,0,1819,1855,True,131,94,sebsi:1  marzouki:1  
2,2,5,14,2,432,324,502,0,178,324,502,0,0,316,3,5,324,0,1830,1920,True,199,117,sebsi:1  marzouki:1  
2,2,5,14,1,432,312,500,0,188,312,500,0,0,294,10,8,312,0,1800,2005,False,195,99,sebsi:1  marzouki:1  
2,2,5,13,3,432,259,500,0,241,259,500,0,0,254,2,3,259,0,1813,1850,False,144,110,sebsi:1  marzouki:1  
2,2,5,13,2,434,302,503,0,201,302,503,0,0,294,3,5,302,0,1830,1920,False,166,128,sebsi:1  marzouki:1  
2,2,4,12,3,599,386,700,0,314,386,700,0,0,378,4,4,386,0,1825,1955,False,183,195,sebsi:1  marzouki:1  
2,2,4,12,2,599,387,700,0,314,386,700,0,1,372,7,7,386,0,1815,,True,221,151,sebsi:1  marzouki:1  
2,2,4,12,1,599,419,700,0,281,419,700,0,0,402,5,12,419,0,1823,1917,False,258,144,sebsi:1  marzouki:1  
2,2,3,11,3,486,311,600,0,289,311,600,0,0,295,6,10,311,0,1815,1910,False,207,88,sebsi:1  marzouki:1  
2,2,3,11,2,488,373,600,1,226,373,600,0,0,366,3,4,373,0,1830,,True,229,137,sebsi:1  marzouki:1  
2,2,3,11,1,488,396,596,0,200,396,596,0,0,388,4,4,396,0,1815,,True,306,82,sebsi:1  marzouki:1  
2,2,3,10,3,574,351,700,0,349,351,700,0,0,343,5,3,351,0,1830,1930,False,172,171,sebsi:1  marzouki:1  
2,2,3,10,2,575,406,705,1,298,406,705,0,0,395,8,3,406,0,1830,2010,False,218,177,sebsi:1  marzouki:1  
2,2,3,10,1,575,425,696,0,271,425,696,0,0,410,14,1,425,0,1825,1939,True,271,139,sebsi:1  marzouki:1  
2,2,2,9,2,413,228,502,1,273,228,502,0,0,226,1,1,228,0,1814,1850,True,127,99,sebsi:1  marzouki:1  
2,2,2,9,1,414,274,500,3,223,274,500,0,0,257,15,2,274,0,,1950,False,167,90,sebsi:1  marzouki:1  
2,2,2,8,5,545,294,598,0,304,294,598,0,0,283,7,4,294,0,1820,1920,False,161,122,sebsi:1  marzouki:1  
2,2,2,8,4,548,338,600,0,262,338,600,0,0,329,5,4,338,0,1820,1920,True,169,160,sebsi:1  marzouki:1  
2,2,2,8,3,548,349,600,1,250,349,600,0,0,342,6,1,349,0,1815,1915,True,197,145,sebsi:1  marzouki:1  
2,2,2,8,2,548,360,600,0,240,360,600,0,0,352,4,4,360,0,1900,1945,False,226,126,sebsi:1  marzouki:1  
2,2,2,8,1,548,363,600,0,237,363,600,0,0,351,8,4,363,0,1825,1921,False,245,106,sebsi:1  marzouki:1  
2,2,2,7,5,491,262,600,0,338,262,600,0,0,257,4,1,262,0,1815,1850,True,138,119,sebsi:1  marzouki:1  
2,2,2,7,4,493,272,596,0,324,272,596,0,0,267,2,3,272,0,1830,1930,False,128,139,sebsi:1  marzouki:1  
2,2,2,7,3,493,314,596,0,282,314,596,0,0,304,9,1,314,0,1815,1840,True,172,132,sebsi:1  marzouki:1  
2,2,2,7,2,493,310,600,0,290,310,600,0,0,302,7,1,310,0,1815,1845,True,198,104,sebsi:1  marzouki:1  
2,2,1,6,3,506,334,600,1,265,334,600,0,0,327,4,3,334,0,1820,1900,False,223,104,sebsi:1  marzouki:1  
2,2,1,6,2,506,383,600,0,217,383,600,0,0,374,8,1,383,0,1815,1900,False,240,134,sebsi:1  marzouki:1  
2,2,1,6,1,506,386,600,1,213,386,600,0,0,383,2,1,386,0,0800,1915,False,300,83,sebsi:1  marzouki:1  
2,2,1,5,4,565,403,600,1,196,403,600,0,0,388,11,4,403,0,1830,2000,True,305,83,sebsi:1  marzouki:1  
2,2,1,5,3,565,416,600,0,184,416,600,0,0,408,5,3,416,0,1830,1928,False,280,128,sebsi:1  marzouki:1  
2,2,1,5,2,565,461,600,1,138,461,600,0,0,445,7,9,461,0,1830,1915,False,340,105,sebsi:1  marzouki:1  
2,2,1,5,1,565,470,600,0,130,470,600,0,0,458,8,4,470,0,1815,1955,False,374,84,sebsi:1  marzouki:1  
2,6,4,55,3,430,289,500,0,211,289,500,0,0,278,5,6,289,0,1815,1850,False,204,74,sebsi:1  marzouki:1  
2,6,4,55,2,430,304,500,0,196,304,500,0,0,302,1,1,304,0,,1930,True,222,80,sebsi:1  marzouki:1  
2,6,4,55,1,430,355,500,1,144,355,500,0,0,347,6,2,355,0,1800,1930,True,278,69,sebsi:1  marzouki:1  
2,6,4,54,6,554,341,600,0,259,341,600,0,0,329,8,4,341,0,1805,1835,True,256,73,sebsi:1  marzouki:1  
2,6,4,54,5,559,390,608,0,219,389,608,0,1,383,2,4,389,0,1815,1916,True,303,80,sebsi:1  marzouki:1  
2,6,4,54,4,559,407,605,0,198,407,605,0,0,397,6,4,407,0,1815,2025,True,303,94,sebsi:1  marzouki:1  
2,6,4,54,3,559,457,600,2,141,457,600,0,0,453,0,4,457,0,1810,1900,False,343,110,sebsi:1  marzouki:1  
2,6,4,54,2,559,490,596,1,105,490,596,0,0,481,7,2,490,0,1830,2010,True,401,80,sebsi:1  marzouki:1  
2,6,4,54,1,559,490,600,1,109,490,600,0,0,479,7,4,490,0,1815,1925,True,409,70,sebsi:1  marzouki:1  
2,6,3,53,8,553,360,600,0,240,360,600,0,0,353,5,2,360,0,1825,1915,True,292,61,sebsi:1  marzouki:1  
2,6,3,53,7,553,399,600,4,197,399,600,0,0,382,10,7,399,0,1830,1950,True,312,70,sebsi:1  marzouki:1  
2,6,3,53,6,553,388,601,0,213,388,601,0,0,380,4,4,388,0,1830,1947,True,312,68,sebsi:1  marzouki:1  
2,6,3,53,5,553,389,600,5,206,389,600,0,0,382,5,2,389,0,1822,1917,True,299,83,sebsi:1  marzouki:1  
2,6,3,53,4,553,440,600,0,160,440,600,0,0,432,4,4,440,0,1835,1945,False,348,84,sebsi:1  marzouki:1  
2,6,3,53,3,553,453,600,2,145,453,600,0,0,445,2,6,453,0,1820,1933,False,370,75,sebsi:1  marzouki:1  
2,6,3,53,2,553,476,600,0,124,476,600,0,0,472,3,1,476,0,,1935,False,417,55,sebsi:1  marzouki:1  
2,6,3,53,1,553,459,600,8,133,459,600,0,0,446,7,6,459,0,1820,1938,False,394,52,sebsi:1  marzouki:1  
2,6,3,52,8,592,455,699,0,244,455,699,0,0,432,7,16,455,0,1830,1915,True,370,62,sebsi:1  marzouki:1  
2,6,3,52,7,596,483,700,0,217,483,700,0,0,468,7,8,483,0,1835,1940,True,416,52,sebsi:1  marzouki:1  
2,6,3,52,6,596,438,696,0,259,437,696,0,1,428,4,5,437,0,,2000,True,352,76,sebsi:1  marzouki:1  
2,6,3,52,5,596,498,703,0,205,498,703,0,0,491,3,4,498,0,1830,1930,False,417,74,sebsi:1  marzouki:1  
2,6,3,52,4,596,503,694,0,191,503,694,0,0,496,3,4,503,0,,1923,False,404,92,sebsi:1  marzouki:1  
2,6,3,52,3,596,539,700,3,158,539,700,0,0,532,4,3,539,0,1830,2000,True,470,62,sebsi:1  marzouki:1  
2,6,3,52,2,596,543,702,1,158,543,702,0,0,540,3,0,543,0,1827,1952,False,477,63,sebsi:1  marzouki:1  
2,6,3,52,1,596,526,700,0,174,526,700,0,0,516,7,3,526,0,1825,1945,True,465,51,sebsi:1  marzouki:1  
2,6,3,51,7,568,428,604,0,176,428,604,0,0,413,9,6,428,0,1830,1940,False,350,63,sebsi:1  marzouki:1  
2,6,3,51,6,570,441,596,0,155,441,596,0,0,432,3,6,441,0,1830,2000,False,359,73,sebsi:1  marzouki:1  
2,6,3,51,5,570,474,600,2,126,472,600,0,2,460,7,5,472,0,1825,1915,False,366,94,sebsi:1  marzouki:1  
2,6,3,51,4,570,504,600,3,93,504,600,0,0,498,2,4,504,0,1820,1930,False,410,88,sebsi:1  marzouki:1  
2,6,3,51,3,570,528,600,1,72,527,600,0,1,520,1,6,527,0,1815,1925,False,455,65,sebsi:1  marzouki:1  
2,6,3,51,2,570,502,600,0,98,502,600,0,0,500,1,1,502,0,1830,2000,False,454,46,sebsi:1  marzouki:1  
2,6,2,50,4,553,364,600,1,235,364,600,0,0,348,7,9,364,0,1845,1905,True,281,67,sebsi:1  marzouki:1  
2,6,2,50,3,554,375,598,0,223,375,598,0,0,371,1,3,375,0,1830,2000,False,291,80,sebsi:1  marzouki:1  
2,6,2,50,2,554,441,596,2,153,441,596,0,0,425,10,6,441,0,1850,2020,False,350,75,sebsi:1  marzouki:1  
2,6,2,50,1,554,444,600,4,152,444,600,0,0,434,5,5,444,0,1800,2000,False,380,54,sebsi:1  marzouki:1  
2,6,2,49,7,571,402,700,0,298,402,700,0,0,388,9,5,402,0,1820,1930,False,317,71,sebsi:1  marzouki:1  
2,6,2,49,6,575,448,700,0,252,448,700,0,0,441,5,2,448,0,1835,1941,False,364,77,sebsi:1  marzouki:1  
2,6,2,49,5,575,476,700,2,222,476,700,0,0,470,3,3,476,0,1825,1932,False,376,94,sebsi:1  marzouki:1  
2,6,2,49,4,575,500,700,12,188,500,700,0,0,492,4,4,500,0,1822,1928,False,412,80,sebsi:1  marzouki:1  
2,6,1,48,3,585,397,700,1,302,397,700,0,0,390,2,5,397,0,1822,1915,False,332,58,sebsi:1  marzouki:1  
2,6,1,48,2,587,457,711,2,252,457,711,0,0,450,3,4,457,0,1835,1930,True,374,76,sebsi:1  marzouki:1  
2,6,1,48,1,587,474,700,0,226,474,700,0,0,462,8,4,474,0,1815,1925,False,405,57,sebsi:1  marzouki:1  
2,6,1,47,6,577,442,700,0,258,442,700,0,0,434,5,3,442,0,1815,1933,True,377,57,sebsi:1  marzouki:1  
2,6,1,47,5,577,484,700,0,216,484,700,0,0,483,0,1,484,0,1815,1850,False,439,44,sebsi:1  marzouki:1  
2,6,1,47,4,577,487,700,1,212,487,700,0,0,477,3,7,487,0,1812,1915,True,401,76,sebsi:1  marzouki:1  
2,6,1,47,3,577,517,701,0,184,517,701,0,0,508,6,3,517,0,1830,1950,False,465,43,sebsi:1  marzouki:1  
2,6,1,47,2,577,494,700,1,205,494,700,0,0,485,6,3,494,0,1817,1920,True,450,35,sebsi:1  marzouki:1  
2,6,1,47,1,577,500,700,0,200,500,700,0,0,492,5,3,500,0,1800,1850,False,452,40,sebsi:1  marzouki:1  
2,9,4,80,6,531,372,600,3,225,372,600,0,0,361,7,4,372,0,1808,1900,True,320,41,sebsi:1  marzouki:1  
2,9,4,80,5,531,396,600,2,202,396,600,0,0,389,2,5,396,0,1820,1912,True,343,46,sebsi:1  marzouki:1  
2,9,4,80,4,531,442,603,0,161,442,603,0,0,434,4,4,442,0,1815,1930,False,366,68,sebsi:1  marzouki:1  
2,9,4,80,3,531,436,600,0,164,436,600,0,0,434,2,0,436,0,1800,1900,False,387,47,sebsi:1  marzouki:1  
2,9,4,80,2,531,474,603,0,129,474,603,0,0,466,4,4,474,0,,1945,False,412,54,sebsi:1  marzouki:1  
2,9,4,80,1,531,474,600,0,126,474,600,0,0,469,2,3,474,0,1800,1910,True,423,46,sebsi:1  marzouki:1  
2,9,3,79,7,561,311,600,0,289,311,600,0,0,305,5,1,311,0,1830,1930,False,164,141,sebsi:1  marzouki:1  
2,9,3,79,6,561,335,599,0,264,335,599,0,0,330,3,2,335,0,1820,1919,True,175,155,sebsi:1  marzouki:1  
2,9,3,79,5,561,348,600,0,252,348,600,0,0,347,0,1,348,0,1800,1900,False,166,181,sebsi:1  marzouki:1  
2,9,3,79,4,561,382,600,0,218,382,600,0,0,375,3,4,382,0,1830,1951,True,196,179,sebsi:1  marzouki:1  
2,9,3,79,3,561,375,593,1,217,375,593,0,0,358,11,6,375,0,1800,1930,False,220,138,sebsi:1  marzouki:1  
2,9,3,79,2,561,408,600,0,192,408,600,0,0,398,8,2,408,0,1815,1920,False,272,126,sebsi:1  marzouki:1  
2,9,3,79,1,561,407,600,0,193,407,600,0,0,388,17,2,407,0,1805,1930,False,260,128,sebsi:1  marzouki:1  
2,9,2,78,7,580,380,700,0,321,379,700,0,1,371,6,2,379,0,1830,1930,False,218,153,sebsi:1  marzouki:1  
2,9,2,78,6,581,370,700,1,329,370,700,0,0,363,3,4,370,0,1825,1929,True,169,194,sebsi:1  marzouki:1  
2,9,2,78,5,581,394,700,3,303,394,700,0,0,389,3,2,394,0,1830,1945,False,199,190,sebsi:1  marzouki:1  
2,9,2,78,4,581,441,700,0,259,441,700,0,0,431,5,5,441,0,1900,2015,False,244,187,sebsi:1  marzouki:1  
2,9,2,78,3,581,457,700,3,240,457,700,0,0,440,13,4,457,0,1830,1930,False,286,154,sebsi:1  marzouki:1  
2,9,2,78,2,581,443,700,1,256,443,700,0,0,432,9,2,443,0,1810,1947,False,277,155,sebsi:1  marzouki:1  
2,9,2,78,1,581,484,700,0,216,484,700,0,0,474,6,4,484,0,1830,1935,True,317,157,sebsi:1  marzouki:1  
2,9,2,77,8,573,372,699,0,327,372,699,0,0,364,3,5,372,0,1820,1920,False,248,116,sebsi:1  marzouki:1  
2,9,2,77,7,579,388,701,0,313,388,701,0,0,382,1,5,388,0,1820,1930,False,258,124,sebsi:1  marzouki:1  
2,9,2,77,6,579,382,692,2,308,382,692,0,0,370,7,5,382,0,1830,1930,False,225,145,sebsi:1  marzouki:1  
2,9,2,77,5,579,422,700,1,277,422,700,0,0,416,2,4,422,0,,1945,False,216,200,sebsi:1  marzouki:1  
2,9,2,77,4,579,436,700,0,264,436,700,0,0,430,4,2,436,0,1815,1900,True,280,150,sebsi:1  marzouki:1  
2,9,2,77,3,579,446,700,0,254,446,700,0,0,435,5,6,446,0,1820,1918,True,307,128,sebsi:1  marzouki:1  
2,9,2,77,2,579,466,700,1,233,466,700,0,0,458,4,4,466,0,1835,2000,True,369,89,sebsi:1  marzouki:1  
2,9,2,77,1,579,489,701,0,212,489,701,0,0,471,17,1,491,0,1815,1945,True,369,102,sebsi:1  marzouki:1  
2,9,1,76,7,546,293,600,0,307,293,600,0,0,284,7,2,293,0,1843,2015,True,170,114,sebsi:1  marzouki:1  
2,9,1,76,6,548,320,600,0,280,320,600,0,0,316,1,3,320,0,1812,1902,False,196,120,sebsi:1  marzouki:1  
2,9,1,76,5,548,362,596,1,233,362,596,0,0,354,4,4,362,0,1825,1925,False,207,147,sebsi:1  marzouki:1  
2,9,1,76,4,548,404,600,0,196,404,600,0,0,395,5,4,404,0,1815,1900,True,273,122,sebsi:1  marzouki:1  
2,9,1,76,3,548,431,600,6,163,431,600,0,0,417,7,7,431,0,1817,1926,False,299,118,sebsi:1  marzouki:1  
2,9,1,76,2,548,411,600,0,189,411,600,0,0,405,4,2,411,0,1818,1930,False,321,84,sebsi:1  marzouki:1  
2,9,1,76,1,548,418,600,3,179,418,600,0,0,401,16,1,418,0,1830,1935,False,330,71,sebsi:1  marzouki:1  
2,10,6,87,4,538,309,601,0,292,309,601,0,0,295,11,3,309,0,1800,1905,True,201,94,sebsi:1  marzouki:1  
2,10,6,87,3,541,362,600,0,238,362,600,0,0,347,11,4,362,0,1810,1915,True,207,140,sebsi:1  marzouki:1  
2,10,6,87,2,541,403,600,3,194,403,600,0,0,391,10,2,403,0,1815,1930,False,280,111,sebsi:1  marzouki:1  
2,10,6,87,1,541,401,598,1,196,401,598,0,0,377,13,11,401,0,1820,1940,False,294,83,sebsi:1  marzouki:1  
2,10,5,86,7,567,330,596,1,265,330,596,0,0,322,2,6,330,0,1825,1910,False,191,131,sebsi:1  marzouki:1  
2,10,5,86,6,571,294,592,1,298,293,592,0,1,287,4,2,293,0,1805,1900,False,181,106,sebsi:1  marzouki:1  
2,10,5,86,5,571,338,600,17,245,338,600,0,0,329,8,1,338,0,1800,1928,False,195,134,sebsi:1  marzouki:1  
2,10,5,86,4,571,384,600,0,216,384,600,0,0,375,5,4,384,0,1815,1900,True,246,129,sebsi:1  marzouki:1  
2,10,5,86,3,571,387,600,0,213,387,600,0,0,378,6,3,387,0,1840,1900,True,254,124,sebsi:1  marzouki:1  
2,10,5,86,2,571,423,610,0,187,423,610,0,0,405,14,4,423,0,1815,1925,False,276,129,sebsi:1  marzouki:1  
2,10,5,86,1,571,412,600,2,186,412,600,0,0,391,17,4,412,0,1830,1936,False,279,112,sebsi:1  marzouki:1  
2,10,4,85,6,521,363,601,1,237,363,601,0,0,345,13,5,363,0,1810,1915,True,270,75,sebsi:1  marzouki:1  
2,10,4,85,5,526,379,600,0,221,379,600,0,0,365,9,5,379,0,1830,1915,True,296,69,sebsi:1  marzouki:1  
2,10,4,85,4,526,412,600,0,188,412,600,0,0,403,4,5,412,0,1810,1920,False,319,84,sebsi:1  marzouki:1  
2,10,4,85,3,526,437,600,0,163,437,600,0,0,429,5,3,437,0,1805,,False,342,87,sebsi:1  marzouki:1  
2,10,4,85,2,526,455,592,1,136,455,592,0,0,449,2,4,455,0,1810,1915,False,370,79,sebsi:1  marzouki:1  
2,10,4,85,1,526,446,605,3,156,446,605,0,0,441,5,0,446,0,1840,2000,False,371,70,sebsi:1  marzouki:1  
2,10,3,84,5,581,380,700,0,320,380,700,0,0,375,4,1,380,0,1825,1925,False,303,72,sebsi:1  marzouki:1  
2,10,3,84,4,584,422,700,19,259,422,700,0,0,408,9,5,422,0,1845,,False,367,41,sebsi:1  marzouki:1  
2,10,3,84,3,584,478,700,0,222,478,700,0,0,473,2,3,478,0,1830,1930,True,407,66,sebsi:1  marzouki:1  
2,10,3,84,2,584,502,700,1,197,502,700,0,0,496,6,0,502,0,1830,2010,True,445,51,sebsi:1  marzouki:1  
2,10,3,84,1,584,480,699,3,219,479,701,2,1,465,8,6,479,0,1830,2005,True,418,47,sebsi:1  marzouki:1  
2,10,3,83,6,549,345,597,1,251,345,597,0,0,335,5,5,345,0,1838,1905,False,240,95,sebsi:1  marzouki:1  
2,10,3,83,5,554,365,600,0,235,365,600,0,0,354,6,5,365,0,1815,1910,True,278,76,sebsi:1  marzouki:1  
2,10,3,83,4,554,430,612,1,181,430,612,0,0,417,9,4,430,0,1820,2000,True,297,120,sebsi:1  marzouki:1  
2,10,3,83,3,554,450,600,0,150,449,599,1,1,444,1,4,449,0,,1930,False,338,106,sebsi:1  marzouki:1  
2,10,3,83,2,554,454,600,0,146,454,600,0,0,447,5,2,454,0,,2005,False,341,106,sebsi:1  marzouki:1  
2,10,3,83,1,554,457,592,1,134,457,592,0,0,447,10,0,457,0,1820,1930,False,377,70,sebsi:1  marzouki:1  
2,10,2,82,3,567,378,600,1,221,378,600,0,0,371,3,4,378,0,1820,1930,False,264,107,sebsi:1  marzouki:1  
2,10,2,82,2,568,447,596,6,143,447,596,0,0,438,9,0,447,0,1830,1935,False,316,122,sebsi:1  marzouki:1  
2,10,2,82,1,568,470,596,0,126,470,596,0,0,467,2,1,470,0,1800,2000,False,351,116,sebsi:1  marzouki:1  
2,10,1,81,6,581,326,700,2,372,326,700,0,0,320,3,3,326,0,,1915,False,235,85,sebsi:1  marzouki:1  
2,10,1,81,5,584,418,700,0,282,418,700,0,0,409,4,5,418,0,1820,2004,False,336,73,sebsi:1  marzouki:1  
2,10,1,81,4,584,454,700,1,245,454,700,0,0,442,8,4,454,0,1835,1950,True,362,80,sebsi:1  marzouki:1  
2,10,1,81,3,584,442,700,0,258,442,700,0,0,434,3,5,442,0,1830,1928,False,364,70,sebsi:1  marzouki:1  
2,10,1,81,2,584,498,693,1,194,498,693,0,0,488,7,3,498,0,2025,2025,True,403,85,sebsi:1  marzouki:1  
2,10,1,81,1,584,500,700,0,200,500,700,0,0,488,9,3,500,0,1805,1900,True,416,72,sebsi:1  marzouki:1  
