circonscriptionId,delegationId,subDelegationId,centerID,stationId,registeredVoters,aSigningVoters,bDeliveredBallots,cSpoiledBallots,dLeftBallots,fExtractedBallots,gEplusF,hBminusG,iAminusF,jListVotes,kCancelledVotes,lBlankVotes,mJplusKplusL,nFminusM,countingStart,countingEnd,tampon,sebsi,marzouki,observers
22,9,5,120,1,358,237,399,0,162,237,399,0,0,233,3,1,237,0,1805,1930,True,141,92,sebsi:1  marzouki:1  
22,9,5,119,4,517,265,600,0,335,265,600,0,0,260,3,2,265,0,1815,1930,True,152,108,sebsi:1  marzouki:1  
22,9,5,119,3,520,279,600,1,320,279,600,0,0,272,6,1,279,0,1800,1845,True,148,124,sebsi:1  marzouki:1  
22,9,5,119,2,520,334,606,0,272,334,606,0,0,331,3,0,334,0,1820,1928,True,207,124,sebsi:1  marzouki:1  
22,9,5,119,1,520,321,600,0,279,321,600,0,0,309,8,4,321,0,1820,1930,True,234,75,sebsi:1  marzouki:1  
22,9,4,118,1,422,256,500,0,244,256,500,0,0,247,7,2,256,0,1805,1900,True,193,54,sebsi:1  marzouki:1  
22,9,4,117,3,558,309,600,0,291,309,600,0,0,294,11,4,309,0,1800,1900,True,180,114,sebsi:1  marzouki:1  
22,9,4,117,2,560,350,599,1,248,350,599,0,0,347,1,2,350,0,1800,1930,True,202,145,sebsi:1  marzouki:1  
22,9,4,117,1,560,386,600,1,213,386,600,0,0,383,3,0,386,0,1802,1900,True,284,99,sebsi:1  marzouki:1  
22,9,4,116,4,548,279,600,0,321,279,600,0,0,276,3,0,279,0,1815,1900,True,178,98,sebsi:1  marzouki:1  
22,9,4,116,3,550,329,600,0,271,329,600,0,0,326,2,1,329,0,1815,1910,True,184,142,sebsi:1  marzouki:1  
22,9,4,116,2,550,378,601,0,223,378,601,0,0,370,5,3,378,0,1800,1900,True,240,130,sebsi:1  marzouki:1  
22,9,4,116,1,550,368,600,0,232,368,600,0,0,349,17,2,368,0,,1920,True,267,82,sebsi:1  marzouki:1  
22,9,3,115,1,447,235,500,0,265,235,500,0,0,221,10,4,235,0,1800,1855,True,193,28,sebsi:1  marzouki:1  
22,9,3,114,1,577,326,700,0,374,326,700,0,0,317,6,3,326,0,1815,1945,True,262,55,sebsi:1  marzouki:1  
22,9,3,113,1,365,157,400,0,243,157,400,0,0,155,2,0,157,0,1805,1845,True,145,10,sebsi:1  marzouki:1  
22,9,2,112,1,349,234,400,0,166,234,400,0,0,228,3,3,234,0,1805,1835,True,164,64,sebsi:1  marzouki:1  
22,9,2,111,2,313,155,400,0,245,155,400,0,0,154,0,1,155,0,1810,1900,True,111,43,sebsi:1  marzouki:1  
22,9,2,111,1,314,214,400,0,186,214,400,0,0,208,4,2,214,0,1811,1844,True,162,46,sebsi:1  marzouki:1  
22,9,2,110,1,379,187,411,0,224,187,411,0,0,181,4,2,187,0,1805,1855,True,151,30,sebsi:1  marzouki:1  
22,9,2,109,1,560,244,600,0,356,244,600,0,0,236,8,0,244,0,1815,,True,165,71,sebsi:1  marzouki:1  
22,9,1,108,1,125,45,200,0,155,45,200,0,0,43,2,0,45,0,1815,1845,True,24,19,sebsi:1  marzouki:1  
22,9,1,107,2,483,208,600,0,392,208,600,0,0,207,1,0,208,0,1800,1910,True,112,95,sebsi:1  marzouki:1  
22,9,1,107,1,484,297,600,1,302,297,600,0,0,294,3,0,297,0,1815,1853,True,224,70,sebsi:1  marzouki:1  
22,11,5,134,4,499,306,600,5,289,306,600,0,0,295,8,3,306,0,1800,1835,True,181,114,sebsi:1  marzouki:1  
22,11,5,134,3,500,332,600,1,267,332,600,0,0,322,6,4,332,0,1820,1845,True,221,101,sebsi:1  marzouki:1  
22,11,5,134,2,500,390,600,1,209,390,600,0,0,382,3,5,390,0,,,True,233,149,sebsi:1  marzouki:1  
22,11,5,134,1,500,376,600,0,224,376,600,0,0,368,6,2,376,0,1805,1845,True,288,80,sebsi:1  marzouki:1  
22,11,4,133,1,583,384,700,3,313,384,700,0,0,379,4,1,384,0,1812,1930,True,277,102,sebsi:1  marzouki:1  
22,11,4,132,5,521,329,602,0,273,329,602,0,0,323,4,2,329,0,1815,1910,True,204,119,sebsi:1  marzouki:1  
22,11,4,132,4,522,324,600,1,275,324,600,0,0,319,3,2,324,0,1815,1925,True,217,102,sebsi:1  marzouki:1  
22,11,4,132,3,522,367,600,0,233,367,600,0,0,359,6,2,367,0,1830,1916,True,218,141,sebsi:1  marzouki:1  
22,11,4,132,2,522,421,600,3,176,421,600,0,0,415,3,3,421,0,1820,1915,True,268,147,sebsi:1  marzouki:1  
22,11,4,132,1,522,370,601,0,231,370,601,0,0,361,7,2,370,0,1815,1910,True,261,100,sebsi:1  marzouki:1  
22,11,4,131,3,434,244,500,0,256,244,500,0,0,239,2,3,244,0,805,1910,True,139,100,sebsi:1  marzouki:1  
22,11,4,131,2,436,304,504,0,200,304,504,0,0,298,4,2,304,0,1830,1925,True,179,119,sebsi:1  marzouki:1  
22,11,4,131,1,436,330,500,0,170,330,500,0,0,325,3,2,330,0,1820,1920,True,232,93,sebsi:1  marzouki:1  
22,11,4,130,3,523,307,600,0,293,307,600,0,0,293,13,1,307,0,1810,1915,True,194,99,sebsi:1  marzouki:1  
22,11,4,130,2,525,370,600,0,230,370,600,0,0,359,6,5,370,0,1820,1950,True,257,102,sebsi:1  marzouki:1  
22,11,4,130,1,525,381,603,0,222,381,603,0,0,370,7,4,381,0,1800,1930,True,282,88,sebsi:1  marzouki:1  
22,11,3,129,6,572,312,704,0,392,312,704,0,0,302,5,5,312,0,1800,,True,172,130,sebsi:1  marzouki:1  
22,11,3,129,5,572,318,700,0,382,318,700,0,0,311,6,1,318,0,1800,1915,True,195,116,sebsi:1  marzouki:1  
22,11,3,129,4,572,376,700,0,324,376,700,0,0,369,2,5,376,0,1815,1900,True,263,106,sebsi:1  marzouki:1  
22,11,3,129,3,572,404,700,0,296,404,700,0,0,403,1,0,404,0,1800,1900,True,247,156,sebsi:1  marzouki:1  
22,11,3,129,2,572,428,701,1,272,428,701,0,0,419,7,2,428,0,1815,1910,True,298,121,sebsi:1  marzouki:1  
22,11,3,129,1,572,422,700,0,279,421,700,0,1,409,8,4,421,0,1815,1930,True,298,111,sebsi:1  marzouki:1  
22,11,2,128,3,466,247,500,4,249,247,500,0,0,241,2,4,247,0,1822,1905,True,136,105,sebsi:1  marzouki:1  
22,11,2,128,2,466,318,500,0,182,318,500,0,0,312,2,4,318,0,1809,1855,True,180,132,sebsi:1  marzouki:1  
22,11,2,128,1,466,350,500,0,150,350,500,0,0,341,6,3,350,0,1801,1910,True,216,125,sebsi:1  marzouki:1  
22,11,1,127,7,565,308,600,0,292,308,600,0,0,304,2,2,308,0,1815,1910,True,187,117,sebsi:1  marzouki:1  
22,11,1,127,6,567,334,600,1,265,334,600,0,0,328,5,1,334,0,1815,1905,True,206,122,sebsi:1  marzouki:1  
22,11,1,127,5,567,363,599,0,236,363,599,0,0,357,3,3,363,0,1815,1855,True,259,98,sebsi:1  marzouki:1  
22,11,1,127,4,567,400,600,0,200,400,600,0,0,395,3,2,400,0,1800,1855,True,276,119,sebsi:1  marzouki:1  
22,11,1,127,3,567,450,600,0,150,450,600,0,0,441,3,6,450,0,1810,1850,True,304,137,sebsi:1  marzouki:1  
22,11,1,127,2,567,421,601,1,180,420,601,0,1,407,11,2,420,0,1830,1918,True,315,92,sebsi:1  marzouki:1  
22,11,1,127,1,567,439,600,0,161,439,600,0,0,431,2,6,439,0,1815,1915,True,321,110,sebsi:1  marzouki:1  
22,10,4,126,6,520,286,600,0,314,286,600,0,0,283,2,1,286,0,1810,1915,True,184,99,sebsi:1  marzouki:1  
22,10,4,126,5,524,351,600,0,249,351,600,0,0,343,5,3,351,0,1815,1915,True,286,57,sebsi:1  marzouki:1  
22,10,4,126,4,524,385,600,0,215,385,600,0,0,379,5,1,385,0,1805,1900,True,313,66,sebsi:1  marzouki:1  
22,10,4,126,3,524,372,600,0,228,372,600,0,0,364,6,2,372,0,1820,1928,True,285,79,sebsi:1  marzouki:1  
22,10,4,126,2,524,450,600,1,149,450,600,0,0,439,3,8,450,0,1810,1930,True,368,71,sebsi:1  marzouki:1  
22,10,4,126,1,524,411,598,4,183,411,598,0,0,399,6,6,411,0,1832,1942,True,324,75,sebsi:1  marzouki:1  
22,10,3,125,3,404,260,500,0,240,260,500,0,0,250,9,1,260,0,1800,1915,True,220,30,sebsi:1  marzouki:1  
22,10,3,125,2,405,305,500,0,195,305,500,0,0,301,4,0,305,0,1810,1905,True,264,37,sebsi:1  marzouki:1  
22,10,3,125,1,405,330,499,5,164,330,499,0,0,323,6,1,330,0,1820,1910,True,303,20,sebsi:1  marzouki:1  
22,10,3,124,3,593,390,703,0,313,390,703,0,0,378,5,7,390,0,1830,1903,True,321,57,sebsi:1  marzouki:1  
22,10,3,124,2,593,472,700,0,228,472,700,0,0,464,7,1,472,0,1830,1905,True,384,80,sebsi:1  marzouki:1  
22,10,3,124,1,593,489,700,0,211,489,700,0,0,481,2,6,489,0,1810,1945,True,446,35,sebsi:1  marzouki:1  
22,10,2,123,6,556,327,604,1,276,327,604,0,0,309,12,6,327,0,1821,1925,True,206,103,sebsi:1  marzouki:1  
22,10,2,123,5,559,345,600,0,255,345,600,0,0,337,5,3,345,0,1817,1904,True,249,88,sebsi:1  marzouki:1  
22,10,2,123,4,559,427,600,1,172,427,600,0,0,415,5,7,427,0,1820,2000,True,292,123,sebsi:1  marzouki:1  
22,10,2,123,3,559,437,600,3,160,437,600,0,0,425,7,5,437,0,1820,1930,True,292,133,sebsi:1  marzouki:1  
22,10,2,123,2,559,443,600,1,156,443,600,0,0,437,5,1,443,0,1800,1910,True,361,76,sebsi:1  marzouki:1  
22,10,2,123,1,559,455,600,3,142,455,600,0,0,446,7,2,455,0,1815,1930,True,355,91,sebsi:1  marzouki:1  
22,10,1,122,6,522,308,600,0,292,308,600,0,0,299,8,1,308,0,1840,1910,True,217,82,sebsi:1  marzouki:1  
22,10,1,122,5,523,332,600,2,266,332,600,0,0,321,7,4,332,0,1840,2000,True,243,78,sebsi:1  marzouki:1  
22,10,1,122,4,523,365,600,0,235,365,600,0,0,358,4,3,365,0,1825,1920,True,265,93,sebsi:1  marzouki:1  
22,10,1,122,3,523,405,600,2,193,405,600,0,0,396,5,4,405,0,1810,1945,True,285,111,sebsi:1  marzouki:1  
22,10,1,122,1,523,413,600,3,184,413,600,0,0,397,10,6,413,0,,1942,True,323,74,sebsi:1  marzouki:1  
22,10,1,121,2,481,313,600,1,286,313,600,0,0,303,6,4,313,0,1820,1845,True,215,88,sebsi:1  marzouki:1  
22,10,1,121,1,481,380,600,0,220,380,600,0,0,373,5,2,380,0,1815,1945,True,279,94,sebsi:1  marzouki:1  
22,2,5,13,2,490,292,600,0,308,292,600,0,0,284,4,4,292,0,1830,1910,True,210,74,sebsi:1  marzouki:1  
22,2,5,13,1,491,397,600,0,203,397,600,0,0,391,5,1,397,0,1820,1920,True,282,109,sebsi:1  marzouki:1  
22,2,4,12,4,524,252,600,0,348,252,600,0,0,246,4,2,252,0,1830,1920,True,140,106,sebsi:1  marzouki:1  
22,2,4,12,3,524,286,599,2,311,286,599,0,0,276,8,2,286,0,1820,1915,False,187,89,sebsi:1  marzouki:1  
22,2,4,12,2,524,361,600,1,238,361,600,0,0,355,6,0,361,0,1830,1945,True,254,101,sebsi:1  marzouki:1  
22,2,4,12,1,524,368,600,1,232,367,600,0,1,357,4,6,367,0,1810,1920,True,240,117,sebsi:1  marzouki:1  
22,2,3,11,6,531,274,600,0,326,274,600,0,0,266,4,4,274,0,1810,1900,True,172,94,sebsi:1  marzouki:1  
22,2,3,11,5,531,340,600,0,260,340,600,0,0,332,3,5,340,0,1800,1900,True,216,116,sebsi:1  marzouki:1  
22,2,3,11,4,531,382,600,0,218,382,600,0,0,375,4,3,382,0,1800,1913,False,261,114,sebsi:1  marzouki:1  
22,2,3,11,3,531,404,600,1,195,404,600,0,0,401,2,1,404,0,1805,1905,True,285,116,sebsi:1  marzouki:1  
22,2,3,11,2,531,434,600,0,166,434,600,0,0,421,11,2,434,0,1805,1915,True,339,82,sebsi:1  marzouki:1  
22,2,3,11,1,531,384,600,1,215,384,600,0,0,372,11,1,384,0,1800,1900,True,272,100,sebsi:1  marzouki:1  
22,2,2,10,6,524,300,601,0,301,300,601,0,0,296,3,1,300,0,1800,1900,True,136,160,sebsi:1  marzouki:1  
22,2,2,10,5,529,334,600,1,265,334,600,0,0,325,7,2,334,0,1800,1930,True,187,138,sebsi:1  marzouki:1  
22,2,2,10,4,529,391,592,1,200,391,592,0,0,384,3,4,391,0,1900,1935,True,222,162,sebsi:1  marzouki:1  
22,2,2,10,3,529,422,600,2,176,422,600,0,0,413,5,4,422,0,1800,1920,True,221,192,sebsi:1  marzouki:1  
22,2,2,10,2,529,394,600,0,206,394,600,0,0,379,13,2,394,0,1815,1930,True,224,155,sebsi:1  marzouki:1  
22,2,2,10,1,529,410,600,1,189,410,600,0,0,403,4,3,410,0,1830,1915,True,232,171,sebsi:1  marzouki:1  
22,2,1,9,2,457,254,500,0,246,254,500,0,0,249,2,3,254,0,1815,1900,True,174,75,sebsi:1  marzouki:1  
22,2,1,9,1,457,316,500,0,184,316,500,0,0,308,7,1,316,0,1815,1850,True,188,120,sebsi:1  marzouki:1  
22,2,1,8,6,556,319,600,0,281,319,600,0,0,313,6,0,319,0,1830,1920,True,157,156,sebsi:1  marzouki:1  
22,2,1,8,5,559,348,600,0,252,348,600,0,0,339,6,3,348,0,1820,1920,False,192,147,sebsi:1  marzouki:1  
22,2,1,8,4,559,400,599,0,199,400,599,0,0,382,12,6,400,0,1830,2010,True,203,179,sebsi:1  marzouki:1  
22,2,1,8,3,559,441,600,1,158,441,600,0,0,431,9,1,441,0,1825,1930,True,221,210,sebsi:1  marzouki:1  
22,2,1,8,2,559,415,600,0,185,415,600,0,0,386,25,4,415,0,1800,1905,True,218,168,sebsi:1  marzouki:1  
22,2,1,8,1,559,431,602,1,170,431,602,0,0,418,10,3,431,0,1825,1930,False,243,175,sebsi:1  marzouki:1  
22,5,4,74,1,510,300,600,0,300,300,600,0,0,290,8,2,300,0,1805,1900,True,254,36,sebsi:1  marzouki:1  
22,5,3,73,2,322,187,400,0,213,187,400,0,0,175,6,6,187,0,1806,1845,True,112,63,sebsi:1  marzouki:1  
22,5,3,73,1,322,227,400,1,172,227,400,0,0,222,2,3,227,0,1805,1835,True,167,55,sebsi:1  marzouki:1  
22,5,2,72,2,470,246,501,0,255,246,501,0,0,242,2,2,246,0,1810,1845,True,140,102,sebsi:1  marzouki:1  
22,5,2,72,1,470,314,502,0,188,314,502,0,0,305,6,3,314,0,,1907,True,213,92,sebsi:1  marzouki:1  
22,5,2,71,2,543,284,600,0,316,284,600,0,0,280,2,2,284,0,1820,1900,True,202,78,sebsi:1  marzouki:1  
22,5,2,71,1,543,349,600,0,251,349,600,0,0,339,7,3,349,0,1825,1925,True,273,66,sebsi:1  marzouki:1  
22,5,2,70,5,542,274,600,0,326,274,600,0,0,271,3,0,274,0,1830,1920,True,168,103,sebsi:1  marzouki:1  
22,5,2,70,4,542,312,621,0,309,312,621,0,0,308,1,3,312,0,1800,1900,True,211,97,sebsi:1  marzouki:1  
22,5,2,70,3,542,370,600,0,230,370,600,0,0,362,6,2,370,0,1815,1905,True,261,101,sebsi:1  marzouki:1  
22,5,2,70,2,542,366,589,0,223,366,589,0,0,358,5,3,366,0,1815,1920,True,254,104,sebsi:1  marzouki:1  
22,5,2,70,1,542,373,600,2,225,373,600,0,0,363,7,3,373,0,1805,1954,True,290,73,sebsi:1  marzouki:1  
22,5,1,69,1,514,330,600,1,269,330,600,0,0,324,3,3,330,0,1800,1900,True,236,88,sebsi:1  marzouki:1  
22,5,1,68,5,508,260,600,0,340,260,600,0,0,253,5,2,260,0,1810,1900,True,164,89,sebsi:1  marzouki:1  
22,5,1,68,4,512,284,600,0,316,284,600,0,0,277,3,4,284,0,1820,1920,True,200,77,sebsi:1  marzouki:1  
22,5,1,68,3,512,326,593,0,267,326,593,0,0,323,2,1,326,0,1820,1915,True,224,99,sebsi:1  marzouki:1  
22,5,1,68,2,512,335,600,0,265,335,600,0,0,328,4,3,335,0,1820,1900,True,228,100,sebsi:1  marzouki:1  
22,5,1,68,1,512,346,600,1,253,346,600,0,0,341,3,2,346,0,1815,1915,True,267,74,sebsi:1  marzouki:1  
22,4,8,67,2,515,333,605,0,272,333,605,0,0,328,4,1,333,0,1815,1945,True,198,130,sebsi:1  marzouki:1  
22,4,8,67,1,516,411,600,0,189,411,600,0,0,403,7,1,411,0,1800,1920,True,284,119,sebsi:1  marzouki:1  
22,4,8,66,3,444,287,500,1,212,287,500,0,0,279,4,4,287,0,1820,1905,True,165,114,sebsi:1  marzouki:1  
22,4,8,66,2,444,324,500,0,176,324,500,0,0,318,3,3,324,0,1800,1930,True,175,143,sebsi:1  marzouki:1  
22,4,8,66,1,444,352,496,2,142,352,496,0,0,343,6,3,352,0,,1950,True,212,131,sebsi:1  marzouki:1  
22,4,8,65,6,502,299,604,3,302,299,604,0,0,290,5,4,299,0,1816,1854,True,164,126,sebsi:1  marzouki:1  
22,4,8,65,5,506,333,600,0,267,333,600,0,0,330,3,0,333,0,,1910,True,196,134,sebsi:1  marzouki:1  
22,4,8,65,4,506,358,601,0,243,358,601,0,0,352,4,2,358,0,1805,1915,True,198,154,sebsi:1  marzouki:1  
22,4,8,65,3,506,387,600,0,213,387,600,0,0,377,6,4,387,0,1800,1915,True,193,184,sebsi:1  marzouki:1  
22,4,8,65,2,506,414,600,2,184,414,600,0,0,402,8,4,414,0,1820,1924,True,213,189,sebsi:1  marzouki:1  
22,4,8,65,1,506,381,600,5,214,381,600,0,0,361,12,8,381,0,1815,1935,True,253,108,sebsi:1  marzouki:1  
22,4,7,64,4,460,202,500,1,297,202,500,0,0,198,4,0,202,0,1800,1800,True,154,44,sebsi:1  marzouki:1  
22,4,7,64,3,460,316,500,0,184,316,500,0,0,302,9,5,316,0,1814,1920,True,265,37,sebsi:1  marzouki:1  
22,4,7,64,2,460,339,500,0,161,339,500,0,0,335,2,2,339,0,1825,1930,True,274,61,sebsi:1  marzouki:1  
22,4,7,64,1,460,357,499,0,142,357,499,0,0,354,1,2,357,0,1800,1900,True,305,49,sebsi:1  marzouki:1  
22,4,7,63,7,545,309,600,0,291,309,600,0,0,300,6,3,309,0,1815,1900,True,206,94,sebsi:1  marzouki:1  
22,4,7,63,6,547,391,600,8,201,391,600,0,0,379,8,4,391,0,1820,1915,True,320,59,sebsi:1  marzouki:1  
22,4,7,63,5,547,418,600,2,180,418,600,0,0,414,1,3,418,0,1810,1905,True,337,77,sebsi:1  marzouki:1  
22,4,7,63,4,547,409,597,2,186,409,597,0,0,398,3,8,409,0,1814,1911,True,282,116,sebsi:1  marzouki:1  
22,4,7,63,3,547,468,600,0,132,468,600,0,0,462,5,1,468,0,1800,1920,True,372,90,sebsi:1  marzouki:1  
22,4,7,63,2,547,471,600,1,128,471,600,0,0,464,3,4,471,0,1830,1935,True,402,62,sebsi:1  marzouki:1  
22,4,7,63,1,547,446,606,3,157,446,606,0,0,442,2,2,446,0,1825,1955,True,330,112,sebsi:1  marzouki:1  
22,4,7,62,8,584,246,700,0,454,246,700,0,0,243,2,1,246,0,1816,1845,True,158,85,sebsi:1  marzouki:1  
22,4,7,62,7,591,420,700,0,280,420,700,0,0,409,6,5,420,0,1815,1920,True,339,70,sebsi:1  marzouki:1  
22,4,7,62,5,591,475,700,3,222,475,700,0,0,466,5,4,475,0,1815,1930,True,385,81,sebsi:1  marzouki:1  
22,4,7,62,4,591,444,700,3,253,444,700,0,0,440,1,3,444,0,1800,1955,True,316,124,sebsi:1  marzouki:1  
22,4,7,62,3,591,516,700,4,180,516,700,0,0,505,7,4,516,0,,1923,True,429,76,sebsi:1  marzouki:1  
22,4,7,62,2,591,520,699,0,179,520,699,0,0,513,5,2,520,0,,1940,True,465,48,sebsi:1  marzouki:1  
22,4,7,62,1,591,502,700,2,196,502,700,0,0,493,6,3,502,0,1823,1932,True,393,100,sebsi:1  marzouki:1  
22,4,6,61,3,401,223,500,0,277,223,500,0,0,212,5,6,223,0,1815,1900,True,130,82,sebsi:1  marzouki:1  
22,4,6,61,2,401,284,500,2,214,284,500,0,0,281,1,2,284,0,1810,1900,True,208,73,sebsi:1  marzouki:1  
22,4,6,61,1,401,295,500,1,204,295,500,0,0,286,5,4,295,0,1800,1915,True,222,64,sebsi:1  marzouki:1  
22,4,6,60,5,495,216,600,1,383,216,600,0,0,211,3,2,216,0,1800,1910,True,68,143,sebsi:1  marzouki:1  
22,4,6,60,4,499,335,600,1,264,335,600,0,0,329,2,4,335,0,1815,1900,True,251,78,sebsi:1  marzouki:1  
22,4,6,60,3,499,354,600,1,245,354,600,0,0,350,1,3,354,0,1825,1930,True,243,107,sebsi:1  marzouki:1  
22,4,6,60,2,499,380,600,2,218,380,600,0,0,372,6,2,380,0,,1910,True,286,86,sebsi:1  marzouki:1  
22,4,6,60,1,499,393,600,1,206,393,600,0,0,382,4,7,393,0,1810,1920,True,277,105,sebsi:1  marzouki:1  
22,4,6,59,4,476,269,500,0,231,269,500,0,0,262,6,1,269,0,1820,1910,True,199,63,sebsi:1  marzouki:1  
22,4,6,59,3,476,347,500,1,152,347,500,0,0,341,3,3,347,0,1820,1910,True,286,55,sebsi:1  marzouki:1  
22,4,6,59,2,476,376,502,0,126,376,502,0,0,371,3,2,376,0,1815,1905,True,301,70,sebsi:  marzouki:  
22,4,6,59,1,476,375,500,1,124,375,500,0,0,365,10,0,375,0,1800,1925,True,300,65,sebsi:  marzouki:  
22,4,6,58,6,533,299,600,1,300,299,600,0,0,289,5,5,299,0,1810,1850,True,195,94,sebsi:  marzouki:  
22,4,6,58,5,533,377,600,0,223,377,600,0,0,369,3,5,377,0,1815,1915,True,308,61,sebsi:  marzouki:  
22,4,6,58,4,533,427,600,1,172,427,600,0,0,419,5,3,427,0,1810,1924,True,337,82,sebsi:  marzouki:  
22,4,6,58,3,533,417,600,0,183,417,600,0,0,408,2,7,417,0,1810,1900,True,307,101,sebsi:  marzouki:  
22,4,6,58,2,533,469,602,0,133,469,602,0,0,465,3,1,469,0,1815,1925,True,393,72,sebsi:  marzouki:  
22,4,6,58,1,533,421,600,3,176,421,600,0,0,410,9,2,421,0,1800,1930,True,320,90,sebsi:  marzouki:  
22,4,5,57,3,407,219,500,0,281,219,500,0,0,211,3,5,219,0,1815,1900,True,123,88,sebsi:  marzouki:  
22,4,5,57,2,408,249,496,0,247,249,496,0,0,245,2,2,249,0,1820,1905,True,139,106,sebsi:  marzouki:  
22,4,5,57,1,408,326,502,0,176,326,502,0,0,321,1,4,326,0,1805,1915,True,227,94,sebsi:  marzouki:  
22,4,5,56,7,534,190,596,2,404,190,596,0,0,186,3,1,190,0,1815,,True,76,110,sebsi:  marzouki:  
22,4,5,56,6,535,342,593,2,249,342,593,0,0,332,7,3,342,0,1815,1915,True,225,107,sebsi:  marzouki:  
22,4,5,56,5,535,378,603,0,225,378,603,0,0,371,4,3,378,0,1800,1930,True,280,91,sebsi:  marzouki:  
22,4,5,56,4,535,394,600,1,205,394,600,0,0,389,4,1,394,0,1830,1945,True,305,84,sebsi:  marzouki:  
22,4,5,56,3,535,391,600,2,207,391,600,0,0,381,7,3,391,0,1830,1925,True,272,109,sebsi:  marzouki:  
22,4,5,56,2,535,459,600,1,140,459,600,0,0,455,1,3,459,0,1815,1920,True,386,69,sebsi:  marzouki:  
22,4,5,56,1,535,377,596,0,219,377,596,0,0,363,9,5,377,0,1800,1940,True,243,120,sebsi:  marzouki:  
22,4,5,55,2,434,239,500,0,261,239,500,0,0,235,1,3,239,0,1810,1850,True,182,53,sebsi:  marzouki:  
22,4,5,55,1,435,312,500,0,188,312,500,0,0,306,4,2,312,0,1820,1920,True,232,74,sebsi:  marzouki:  
22,4,4,54,5,548,335,600,1,264,335,600,0,0,325,6,4,335,0,1810,1925,True,233,92,sebsi:  marzouki:  
22,4,4,54,4,551,379,600,2,219,379,600,0,0,372,2,5,379,0,1815,1940,True,301,71,sebsi:  marzouki:  
22,4,4,54,3,409,409,600,2,189,409,600,0,0,397,7,5,409,0,1800,,True,310,87,sebsi:  marzouki:  
22,4,4,54,2,551,460,600,4,136,460,600,0,0,445,9,6,460,0,1815,1945,True,388,57,sebsi:  marzouki:  
22,4,4,54,1,551,418,600,1,181,418,600,0,0,408,5,5,418,0,1815,1930,True,325,83,sebsi:  marzouki:  
22,4,4,53,4,525,204,600,0,396,204,600,0,0,200,1,3,204,0,1810,1835,True,118,82,sebsi:  marzouki:  
22,4,4,53,3,525,359,599,0,240,359,599,0,0,350,4,5,359,0,1820,1945,True,295,55,sebsi:  marzouki:  
22,4,4,53,2,525,364,599,1,234,364,599,0,0,359,1,4,364,0,1805,2000,True,279,80,sebsi:1  marzouki:1  
22,4,4,53,1,525,389,600,2,209,389,600,0,0,376,9,4,389,0,1810,1950,True,303,73,sebsi:  marzouki:  
22,4,3,52,2,441,262,500,0,238,262,500,0,0,255,6,1,262,0,1800,1915,True,198,57,sebsi:  marzouki:  
22,4,3,52,1,441,348,500,0,152,348,500,0,0,339,5,4,348,0,1805,1850,True,271,68,sebsi:  marzouki:  
22,4,3,51,8,589,284,700,0,416,284,700,0,0,276,4,4,284,0,1827,1915,True,151,125,sebsi:  marzouki:  
22,4,3,51,7,592,425,697,1,271,425,697,0,0,414,7,4,425,0,1815,1915,True,329,85,sebsi:1  marzouki:1  
22,4,3,51,6,592,446,700,0,254,446,700,0,0,434,10,2,446,0,1830,,True,355,79,sebsi:1  marzouki:1  
22,4,3,51,5,592,477,700,4,219,477,700,0,0,466,6,5,477,0,1810,1930,True,362,104,sebsi:1  marzouki:1  
22,4,3,51,4,592,451,700,0,249,451,700,0,0,445,4,2,451,0,1805,1915,True,318,127,sebsi:1  marzouki:1  
22,4,3,51,3,592,527,700,2,171,527,700,0,0,512,11,4,527,0,1830,1935,True,428,84,sebsi:1  marzouki:1  
22,4,3,51,2,592,519,700,3,178,519,700,0,0,506,7,6,519,0,1815,1940,True,451,55,sebsi:1  marzouki:1  
22,4,2,50,4,496,226,601,0,375,226,601,0,0,224,0,2,226,0,1820,1905,True,138,86,sebsi:1  marzouki:1  
22,4,2,50,3,498,378,600,0,222,378,600,0,0,364,6,8,378,0,1800,1915,True,295,69,sebsi:1  marzouki:1  
22,4,2,50,2,498,365,601,3,233,365,601,0,0,358,4,3,365,0,1815,1900,True,260,98,sebsi:1  marzouki:1  
22,4,2,50,1,498,425,600,0,175,425,600,0,0,416,5,4,425,0,1810,1910,True,320,96,sebsi:1  marzouki:1  
22,4,2,49,6,500,245,600,0,355,245,600,0,0,230,10,5,245,0,1800,1910,True,149,81,sebsi:1  marzouki:1  
22,4,2,49,5,505,340,600,0,260,340,600,0,0,331,5,4,340,0,1805,1905,True,282,49,sebsi:1  marzouki:1  
22,4,2,49,4,505,403,601,0,198,403,601,0,0,390,11,2,403,0,1834,1950,True,336,54,sebsi:1  marzouki:1  
22,4,2,49,3,505,365,588,2,221,365,588,0,0,356,7,2,365,0,1830,1930,True,284,72,sebsi:1  marzouki:1  
22,4,2,49,2,505,417,594,0,177,417,594,0,0,401,12,4,417,0,1811,1925,True,359,42,sebsi:1  marzouki:1  
22,4,2,49,1,505,375,600,2,223,375,600,0,0,373,2,0,375,0,1815,1915,True,314,59,sebsi:1  marzouki:1  
22,4,1,48,9,565,144,600,0,456,144,600,0,0,142,0,2,144,0,1810,1845,True,38,104,sebsi:1  marzouki:1  
22,4,1,48,8,570,268,604,0,336,268,604,0,0,256,7,5,268,0,1815,1855,True,129,127,sebsi:1  marzouki:1  
22,4,1,48,7,570,416,600,0,184,416,600,0,0,401,9,6,416,0,1820,1858,True,326,75,sebsi:1  marzouki:1  
22,4,1,48,6,570,403,600,1,196,403,600,0,0,389,8,6,403,0,1835,1952,True,320,69,sebsi:1  marzouki:1  
22,4,1,48,5,570,448,600,0,152,448,600,0,0,436,8,4,448,0,1825,1950,True,341,95,sebsi:1  marzouki:1  
22,4,1,48,4,570,388,600,0,212,388,600,0,0,374,9,5,388,0,1830,1940,True,244,130,sebsi:  marzouki:  
22,4,1,48,3,570,509,607,0,98,509,607,0,0,500,9,0,509,0,1815,1948,True,420,80,sebsi:  marzouki:  
22,4,1,48,2,570,490,600,1,109,490,600,0,0,480,6,4,490,0,1810,1915,True,437,43,sebsi:1  marzouki:1  
22,4,1,48,1,570,426,600,2,172,426,600,0,0,417,5,4,426,0,1820,1920,True,301,116,sebsi:1  marzouki:1  
22,3,13,47,1,458,254,500,0,246,254,500,0,0,240,14,0,254,0,1815,1900,True,147,93,sebsi:1  marzouki:1  
22,3,13,46,1,554,352,601,2,247,352,601,0,0,345,3,4,352,0,1825,1940,True,247,98,sebsi:1  marzouki:1  
22,3,12,45,3,446,183,500,1,316,183,500,0,0,177,5,1,183,0,1810,1846,True,127,50,sebsi:1  marzouki:1  
22,3,12,45,2,448,230,501,0,271,230,501,0,0,226,0,4,230,0,1810,1815,True,156,70,sebsi:1  marzouki:1  
22,3,12,45,1,448,268,500,1,231,268,500,0,0,260,6,2,268,0,1808,,True,207,53,sebsi:1  marzouki:1  
22,3,11,44,1,356,214,400,0,186,214,400,0,0,210,3,1,214,0,1810,1848,True,146,64,sebsi:1  marzouki:1  
22,3,11,43,1,448,284,496,0,212,284,496,0,0,281,1,2,284,0,1821,1925,True,253,28,sebsi:1  marzouki:1  
22,3,11,42,1,423,219,501,0,282,219,501,0,0,208,8,3,219,0,1810,1905,True,159,49,sebsi:1  marzouki:1  
22,3,11,41,3,422,207,501,1,293,207,501,0,0,202,3,2,207,0,1820,1910,True,158,44,sebsi:1  marzouki:1  
22,3,11,41,2,422,220,500,0,280,220,500,0,0,213,6,1,220,0,1810,1845,True,162,51,sebsi:1  marzouki:1  
22,3,11,41,1,422,313,500,0,187,313,500,0,0,301,6,6,313,0,,1930,True,250,51,sebsi:1  marzouki:1  
22,3,11,40,2,513,206,600,0,394,206,600,0,0,203,2,1,206,0,1800,1900,True,139,64,sebsi:1  marzouki:1  
22,3,11,40,1,514,318,600,0,282,318,600,0,0,312,5,1,318,0,1810,1855,True,240,72,sebsi:1  marzouki:1  
22,3,10,39,1,331,220,398,0,178,220,398,0,0,215,2,3,220,0,1820,1945,True,160,55,sebsi:1  marzouki:1  
22,3,10,38,1,116,69,200,0,131,69,200,0,0,68,1,0,69,0,1800,1850,True,56,12,sebsi:1  marzouki:1  
22,3,10,37,1,302,190,500,0,310,190,500,0,0,188,2,0,190,0,1810,,True,156,32,sebsi:1  marzouki:1  
22,3,10,36,1,369,212,400,0,188,212,400,0,0,207,0,5,212,0,1830,1915,True,148,59,sebsi:1  marzouki:1  
22,3,10,35,1,421,217,500,0,283,217,500,0,0,201,7,9,217,0,1805,1910,True,157,44,sebsi:1  marzouki:1  
22,3,10,34,1,359,205,400,0,195,205,400,0,0,200,0,5,205,0,1800,1903,True,185,15,sebsi:1  marzouki:1  
22,3,10,33,2,392,165,500,0,335,165,500,0,0,156,7,2,165,0,1800,1920,True,95,61,sebsi:1  marzouki:1  
22,3,10,33,1,393,258,500,0,242,258,500,0,0,248,5,5,258,0,1815,1915,True,192,56,sebsi:1  marzouki:1  
22,3,9,31,3,411,173,501,0,328,173,501,0,0,172,1,0,173,0,1800,,True,101,71,sebsi:  marzouki:  
22,3,9,31,2,411,268,500,0,232,268,500,0,0,262,4,2,268,0,1810,1900,True,152,110,sebsi:  marzouki:  
22,3,9,31,1,411,272,496,0,224,272,496,0,0,260,7,5,272,0,1805,1915,True,197,63,sebsi:  marzouki:  
22,3,8,30,1,147,85,200,0,115,85,200,0,0,84,0,1,85,0,1816,1835,True,78,6,sebsi:  marzouki:  
22,3,8,29,3,600,242,600,0,358,242,600,0,0,237,3,2,242,0,1800,1845,True,194,43,sebsi:  marzouki:  
22,3,8,29,2,528,339,600,2,259,339,600,0,0,335,1,3,339,0,1810,1856,True,293,42,sebsi:  marzouki:  
22,3,8,29,1,528,398,600,2,200,398,600,0,0,391,5,2,398,0,1815,1855,True,347,44,sebsi:  marzouki:  
22,3,7,27,2,444,252,500,0,248,252,500,0,0,241,1,10,252,0,1810,1855,True,134,107,sebsi:1  marzouki:1  
22,3,7,27,1,444,315,500,0,185,315,500,0,0,309,3,3,315,0,1800,1840,True,241,68,sebsi:1  marzouki:1  
22,3,7,26,1,398,230,496,0,266,230,496,0,0,226,1,3,230,0,1810,1845,True,130,96,sebsi:1  marzouki:1  
22,3,6,25,1,332,254,400,3,143,254,400,0,0,246,6,2,254,0,1830,2000,True,148,98,sebsi:1  marzouki:1  
22,3,6,24,2,526,308,600,2,290,308,600,0,0,299,5,4,308,0,1810,1910,True,233,66,sebsi:  marzouki:  
22,3,6,24,1,527,376,600,0,224,376,600,0,0,367,5,4,376,0,1810,1906,True,289,78,sebsi:  marzouki:  
22,3,6,23,2,428,222,500,1,277,222,500,0,0,218,1,3,222,0,1815,1840,True,182,36,sebsi:  marzouki:  
22,3,6,23,1,428,287,500,0,213,287,500,0,0,284,3,0,287,0,1815,1855,True,244,40,sebsi:  marzouki:  
22,3,6,22,5,497,260,600,1,339,260,600,0,0,257,2,1,260,0,1820,1905,True,201,56,sebsi:  marzouki:  
22,3,6,22,4,500,302,600,0,298,302,600,0,0,298,2,2,302,0,1805,1900,True,220,78,sebsi:  marzouki:  
22,3,6,22,3,500,343,600,0,257,343,600,0,0,339,1,3,343,0,1810,1905,True,255,84,sebsi:  marzouki:  
22,3,6,22,2,500,374,600,0,226,374,600,0,0,370,1,3,374,0,1800,1905,True,280,90,sebsi:  marzouki:  
22,3,6,22,1,500,383,600,0,217,383,600,0,0,371,9,3,383,0,1820,1920,True,309,62,sebsi:  marzouki:  
22,3,5,21,3,563,310,600,1,289,310,600,0,0,302,4,4,310,0,1800,1845,True,240,62,sebsi:  marzouki:  
22,3,5,21,2,564,370,599,0,229,370,599,0,0,364,3,3,370,0,1800,1900,True,287,77,sebsi:  marzouki:  
22,3,5,21,1,564,433,600,0,167,433,600,0,0,422,8,3,433,0,1815,1919,True,353,69,sebsi:  marzouki:  
22,3,5,20,6,518,300,600,0,300,300,600,0,0,287,8,5,300,0,1810,1905,True,217,70,sebsi:  marzouki:  
22,3,5,20,5,523,313,600,0,287,313,600,0,0,310,2,1,313,0,1800,1900,True,225,85,sebsi:  marzouki:  
22,3,5,20,3,523,407,600,0,193,407,600,0,0,394,10,3,407,0,1800,1915,True,275,119,sebsi:  marzouki:  
22,3,5,20,2,523,411,600,1,188,411,600,0,0,403,3,5,411,0,1845,1916,True,306,97,sebsi:  marzouki:  
22,3,5,20,1,523,386,604,1,217,386,604,0,0,379,3,4,386,0,1820,1925,True,306,73,sebsi:1  marzouki:1  
22,3,4,19,2,420,262,501,2,237,262,501,0,0,257,2,3,262,0,1820,1920,True,189,68,sebsi:  marzouki:  
22,3,4,19,1,421,343,500,1,156,343,500,0,0,334,8,1,343,0,1800,1925,True,264,70,sebsi:  marzouki:  
22,3,4,18,6,537,329,600,1,271,328,600,0,1,321,4,3,329,1,1815,1930,True,248,73,sebsi:  marzouki:  
22,3,4,18,5,540,302,600,0,298,302,600,0,0,293,7,2,302,0,1820,1920,True,235,58,sebsi:  marzouki:  
22,3,4,18,4,540,355,600,1,244,355,600,0,0,345,5,5,355,0,1825,1920,True,286,59,sebsi:  marzouki:  
22,3,4,18,3,540,398,600,1,201,398,600,0,0,388,5,5,398,0,1820,1906,True,295,93,sebsi:  marzouki:  
22,3,4,18,2,540,413,597,2,184,411,597,0,2,401,6,4,411,0,,1912,True,328,73,sebsi:  marzouki:  
22,3,4,18,1,540,451,600,2,147,451,600,0,0,443,3,5,451,0,1820,2000,True,377,66,sebsi:1  marzouki:1  
22,3,4,17,6,575,341,700,0,359,341,700,0,0,328,9,4,341,0,1825,1915,True,252,76,sebsi:1  marzouki:1  
22,3,4,17,5,577,352,696,1,343,352,696,0,0,340,7,5,352,0,1820,1905,True,264,76,sebsi:1  marzouki:1  
22,3,4,17,4,577,407,699,0,292,407,699,0,0,400,2,5,407,0,1805,1927,True,311,89,sebsi:1  marzouki:1  
22,3,4,17,3,577,429,704,1,274,429,704,0,0,417,8,4,429,0,1812,1900,True,316,101,sebsi:1  marzouki:1  
22,3,4,17,2,577,436,700,0,264,436,700,0,0,429,5,2,436,0,1800,1900,True,348,81,sebsi:1  marzouki:1  
22,3,4,17,1,577,465,700,0,235,465,700,0,0,455,8,2,465,0,1800,1930,True,386,69,sebsi:1  marzouki:1  
22,3,3,16,5,554,287,600,0,313,287,600,0,0,276,6,5,287,0,,,True,183,93,sebsi:1  marzouki:1  
22,3,3,16,4,556,343,601,0,258,343,601,0,0,332,5,6,343,0,1815,1930,True,252,80,sebsi:1  marzouki:1  
22,3,3,16,3,556,380,600,1,219,380,600,0,0,370,6,4,380,0,1800,1900,True,257,113,sebsi:1  marzouki:1  
22,3,3,16,2,556,454,600,0,146,454,600,0,0,446,5,3,454,0,1815,1945,True,321,125,sebsi:1  marzouki:1  
22,3,3,16,1,552,399,600,3,198,399,600,0,0,388,8,3,399,0,1815,1945,True,319,69,sebsi:1  marzouki:1  
22,3,2,15,4,519,256,600,0,344,256,600,0,0,251,3,2,256,0,1800,1925,True,200,51,sebsi:1  marzouki:1  
22,3,2,15,3,520,271,600,0,329,271,600,0,0,264,6,1,271,0,,1905,True,214,50,sebsi:1  marzouki:1  
22,3,2,15,2,520,366,600,1,233,366,600,0,0,356,5,5,366,0,1811,1935,True,266,90,sebsi:1  marzouki:1  
22,3,2,15,1,520,376,600,0,224,376,600,0,0,364,10,2,376,0,1815,2000,True,308,56,sebsi:1  marzouki:1  
22,3,1,14,4,482,256,600,0,344,256,600,0,0,248,4,4,256,0,1818,1850,True,195,53,sebsi:1  marzouki:1  
22,3,1,14,3,483,293,600,0,307,293,600,0,0,286,3,4,293,0,1819,1845,True,215,71,sebsi:1  marzouki:1  
22,3,1,14,2,483,351,600,2,247,351,600,0,0,347,4,0,351,0,1815,1910,True,279,68,sebsi:1  marzouki:1  
22,3,1,14,1,483,333,600,1,266,333,600,0,0,324,8,1,333,0,1800,1900,True,277,47,sebsi:1  marzouki:1  
22,13,5,155,2,376,246,400,0,154,246,400,0,0,245,1,0,246,0,1815,1915,True,187,58,sebsi:1  marzouki:1  
22,13,5,155,1,377,291,400,1,108,291,400,0,0,287,3,1,291,0,1810,1945,True,232,55,sebsi:1  marzouki:1  
22,13,4,154,1,551,399,601,3,199,399,601,0,0,381,18,0,399,0,1815,,True,325,56,sebsi:1  marzouki:1  
22,13,4,153,5,546,361,600,0,239,361,600,0,0,355,3,3,361,0,1820,1915,True,255,100,sebsi:1  marzouki:1  
22,13,4,153,4,547,374,600,2,224,374,600,0,0,366,6,2,374,0,1815,1927,True,275,91,sebsi:1  marzouki:1  
22,13,4,153,3,547,427,600,1,172,427,600,0,0,420,7,0,427,0,1800,1920,True,324,96,sebsi:1  marzouki:1  
22,13,4,153,2,547,439,600,0,161,439,600,0,0,431,8,0,439,0,1817,1910,True,312,119,sebsi:1  marzouki:1  
22,13,4,153,1,547,428,600,0,172,428,600,0,0,398,27,3,428,0,1820,1916,True,324,74,sebsi:1  marzouki:1  
22,13,3,152,1,457,297,500,0,203,297,500,0,0,293,4,0,297,0,1816,1915,True,218,75,sebsi:1  marzouki:1  
22,13,3,151,4,572,378,700,0,322,378,700,0,0,354,14,10,378,0,1815,1930,True,265,89,sebsi:1  marzouki:1  
22,13,3,151,3,575,428,700,0,272,428,700,0,0,419,6,3,428,0,1800,1915,True,329,90,sebsi:1  marzouki:1  
22,13,3,151,2,575,444,700,1,255,444,700,0,0,434,9,1,444,0,1800,1955,True,327,107,sebsi:1  marzouki:1  
22,13,2,150,3,566,303,600,1,296,303,600,0,0,292,4,7,303,0,1830,1920,True,264,28,sebsi:1  marzouki:1  
22,13,2,150,2,568,415,600,0,185,415,600,0,0,401,11,3,415,0,1815,1945,True,367,34,sebsi:1  marzouki:1  
22,13,2,150,1,568,451,600,4,145,451,600,0,0,442,8,1,451,0,1825,1930,True,419,23,sebsi:1  marzouki:1  
22,13,2,149,4,517,309,600,0,291,309,600,0,0,306,2,1,309,0,1830,,True,280,26,sebsi:1  marzouki:1  
22,13,2,149,3,519,356,600,0,244,356,600,0,0,350,2,4,356,0,1825,1930,True,322,28,sebsi:1  marzouki:1  
22,13,2,149,2,519,413,600,0,187,413,600,0,0,405,3,5,413,0,1820,1925,True,381,24,sebsi:1  marzouki:1  
22,13,2,149,1,519,400,601,1,200,400,601,0,0,391,7,2,400,0,1815,1940,True,369,22,sebsi:1  marzouki:1  
22,13,1,148,3,507,299,600,0,301,299,600,0,0,289,5,5,299,0,1815,1900,True,191,98,sebsi:1  marzouki:1  
22,13,1,148,2,509,381,600,0,219,381,600,0,0,375,5,1,381,0,1805,1917,True,267,108,sebsi:1  marzouki:1  
22,13,1,148,1,509,425,600,2,173,425,600,0,0,418,4,3,425,0,1815,1930,True,328,90,sebsi:1  marzouki:1  
22,13,1,147,5,497,299,600,0,301,299,600,0,0,287,7,5,299,0,1815,1910,True,202,85,sebsi:1  marzouki:1  
22,13,1,147,4,497,332,596,0,264,332,596,0,0,321,9,2,332,0,1810,1915,True,233,88,sebsi:1  marzouki:1  
22,13,1,147,3,497,372,584,1,211,372,584,0,0,363,5,4,372,0,1812,1905,True,273,90,sebsi:1  marzouki:1  
22,13,1,147,2,497,410,600,0,190,410,600,0,0,403,3,4,410,0,1805,1910,True,326,77,sebsi:1  marzouki:1  
22,13,1,147,1,497,410,601,3,188,410,601,0,0,399,9,2,410,0,1800,1915,True,324,75,sebsi:1  marzouki:1  
22,13,1,146,5,589,301,700,0,399,301,700,0,0,289,8,4,301,0,1815,1900,True,187,102,sebsi:1  marzouki:1  
22,13,1,146,4,591,401,700,0,299,401,700,0,0,388,7,6,401,0,1830,1930,False,275,113,sebsi:1  marzouki:1  
22,13,1,146,3,591,454,700,1,245,454,700,0,0,445,2,7,454,0,1800,2019,True,305,140,sebsi:1  marzouki:1  
22,13,1,146,2,591,486,701,0,215,486,701,0,0,477,8,1,486,0,1800,1910,True,363,114,sebsi:1  marzouki:1  
22,13,1,146,1,591,483,700,0,217,483,700,0,0,468,12,3,483,0,1815,1920,True,373,95,sebsi:1  marzouki:1  
22,12,4,145,5,550,254,600,0,346,254,600,0,0,250,4,0,254,0,1815,1935,True,166,84,sebsi:1  marzouki:1  
22,12,4,145,4,552,283,599,0,316,283,599,0,0,274,3,6,283,0,1800,1910,True,214,60,sebsi:1  marzouki:1  
22,12,4,145,3,552,311,600,0,289,311,600,0,0,305,4,2,311,0,1820,1920,True,232,73,sebsi:1  marzouki:1  
22,12,4,145,2,552,394,603,3,206,394,603,0,0,381,4,9,394,0,1805,1930,True,286,95,sebsi:1  marzouki:1  
22,12,4,145,1,552,432,600,0,168,432,600,0,0,420,11,1,432,0,,1905,True,343,77,sebsi:1  marzouki:1  
22,12,4,144,5,527,238,599,0,361,238,599,0,0,232,3,3,238,0,1818,1913,True,140,92,sebsi:1  marzouki:1  
22,12,4,144,4,531,349,600,1,249,350,600,0,1,346,1,3,350,0,1815,1937,True,264,82,sebsi:1  marzouki:1  
22,12,4,144,3,531,372,600,1,227,372,600,0,0,367,4,1,372,0,1820,1933,True,275,92,sebsi:1  marzouki:1  
22,12,4,144,2,531,438,600,1,157,438,596,4,0,434,4,0,438,0,1805,1930,True,366,68,sebsi:1  marzouki:1  
22,12,4,144,1,531,432,600,1,167,432,600,0,0,422,4,6,432,0,1815,1955,True,354,68,sebsi:1  marzouki:1  
22,12,4,143,1,589,272,700,0,428,272,700,0,0,272,0,0,272,0,1830,1900,True,196,76,sebsi:1  marzouki:1  
22,12,3,142,7,523,313,600,0,287,313,600,0,0,310,0,3,313,0,1815,1925,True,228,82,sebsi:1  marzouki:1  
22,12,3,142,6,528,354,600,1,245,354,600,0,0,349,4,1,354,0,1825,1908,True,270,79,sebsi:1  marzouki:1  
22,12,3,142,5,528,388,596,0,208,388,596,0,0,384,0,4,388,0,1815,1930,True,302,82,sebsi:1  marzouki:1  
22,12,3,142,4,528,386,604,0,218,386,604,0,0,379,3,4,386,0,1805,1900,True,293,86,sebsi:1  marzouki:1  
22,12,3,142,3,528,447,604,0,157,447,604,0,0,442,3,2,447,0,1815,1920,True,361,81,sebsi:1  marzouki:1  
22,12,3,142,2,528,424,600,0,176,424,600,0,0,411,9,4,424,0,1815,1905,True,351,60,sebsi:1  marzouki:1  
22,12,3,142,1,528,429,600,0,171,429,600,0,0,424,2,3,429,0,1815,1855,True,355,69,sebsi:1  marzouki:1  
22,12,2,141,3,556,231,600,0,369,231,600,0,0,220,8,3,231,0,1810,1915,True,147,73,sebsi:1  marzouki:1  
22,12,2,141,2,558,287,606,3,316,287,606,0,0,283,4,0,287,0,1815,1910,True,207,76,sebsi:1  marzouki:1  
22,12,2,141,1,558,394,600,0,206,394,600,0,0,385,7,2,394,0,1820,1930,True,293,92,sebsi:1  marzouki:1  
22,12,2,140,6,561,354,608,2,252,354,608,0,0,347,4,3,354,0,1830,1900,True,244,103,sebsi:1  marzouki:1  
22,12,2,140,5,563,379,600,0,221,379,600,0,0,372,6,1,379,0,1800,1930,True,306,66,sebsi:1  marzouki:1  
22,12,2,140,4,563,448,600,1,151,448,600,0,0,443,4,1,448,0,1830,1940,True,362,81,sebsi:1  marzouki:1  
22,12,2,140,3,563,463,600,2,135,463,600,0,0,453,8,2,463,0,1800,1935,True,378,75,sebsi:1  marzouki:1  
22,12,2,140,1,563,446,600,1,153,446,600,0,0,434,7,5,446,0,1835,1940,True,361,73,sebsi:  marzouki:  
22,12,2,139,6,576,327,700,0,373,327,700,0,0,314,10,3,327,0,1830,1930,True,253,61,sebsi:1  marzouki:1  
22,12,2,139,5,577,391,700,0,309,391,700,0,0,379,7,5,391,0,1830,1915,True,305,74,sebsi:1  marzouki:1  
22,12,2,139,4,577,466,700,0,234,466,700,0,0,457,7,2,466,0,1825,1943,True,388,69,sebsi:1  marzouki:1  
22,12,2,139,3,577,450,700,2,248,450,700,0,0,441,6,3,450,0,1800,1930,True,341,100,sebsi:1  marzouki:1  
22,12,2,139,2,577,494,700,5,201,494,700,0,0,480,8,6,494,0,1815,1930,True,402,78,sebsi:1  marzouki:1  
22,12,2,139,1,577,469,706,2,236,468,706,0,1,463,2,3,468,0,1810,1950,True,388,75,sebsi:1  marzouki:1  
22,12,1,138,2,458,313,500,0,187,313,500,0,0,306,4,3,313,0,1812,1855,True,217,89,sebsi:1  marzouki:1  
22,12,1,138,1,458,379,500,0,121,379,500,0,0,366,8,5,379,0,1800,1930,True,270,96,sebsi:1  marzouki:1  
22,12,1,136,4,595,293,700,2,405,293,700,0,0,284,8,1,293,0,1815,1905,True,218,66,sebsi:1  marzouki:1  
22,12,1,136,3,598,393,700,1,306,393,700,0,0,386,4,3,393,0,1800,,True,319,67,sebsi:1  marzouki:1  
22,12,1,136,2,598,401,700,1,299,400,700,0,1,387,10,3,400,0,1815,1855,True,290,97,sebsi:1  marzouki:1  
22,12,1,136,1,598,438,700,0,262,438,700,0,0,420,12,6,438,0,1814,1910,True,352,68,sebsi:1  marzouki:1  
22,12,1,135,3,500,329,600,2,269,329,600,0,0,322,3,4,329,0,1835,1920,True,237,85,sebsi:1  marzouki:1  
22,12,1,135,2,500,389,607,1,217,389,607,0,0,379,8,2,389,0,1837,1941,True,294,85,sebsi:1  marzouki:1  
22,12,1,135,1,500,424,597,1,172,424,597,0,0,416,6,2,424,0,1830,1938,True,341,75,sebsi:1  marzouki:1  
22,8,9,106,1,573,274,700,0,426,274,700,0,0,272,1,1,274,0,1810,1920,True,176,96,sebsi:1  marzouki:1  
22,8,8,105,1,480,275,600,0,325,275,600,0,0,270,5,0,275,0,1815,1900,True,197,73,sebsi:1  marzouki:1  
22,8,7,104,2,587,346,705,0,359,346,705,0,0,340,4,2,346,0,1825,1930,True,186,154,sebsi:1  marzouki:1  
22,8,7,104,1,588,411,700,0,289,411,700,0,0,405,4,2,411,0,1800,1908,True,254,151,sebsi:1  marzouki:1  
22,8,7,103,2,543,240,599,0,359,240,599,0,0,236,1,3,240,0,1817,1909,True,121,115,sebsi:1  marzouki:1  
22,8,7,103,1,543,365,600,0,235,365,600,0,0,360,4,1,365,0,1800,1850,True,208,152,sebsi:1  marzouki:1  
22,8,6,102,2,309,163,400,0,237,163,400,0,0,158,3,2,163,0,1805,1900,True,137,21,sebsi:1  marzouki:1  
22,8,6,102,1,310,213,400,0,187,213,400,0,0,206,1,6,213,0,1800,1844,True,164,42,sebsi:1  marzouki:1  
22,8,5,100,5,522,288,600,0,312,288,600,0,0,280,4,4,288,0,1815,1930,True,186,94,sebsi:1  marzouki:1  
22,8,5,100,4,523,337,600,0,263,337,600,0,0,327,4,6,337,0,1830,1915,True,243,84,sebsi:1  marzouki:1  
22,8,5,100,3,523,388,600,0,212,388,600,0,0,379,6,3,388,0,1805,1852,True,263,116,sebsi:1  marzouki:1  
22,8,5,100,2,523,436,600,0,164,436,600,0,0,427,9,0,436,0,1810,1930,True,300,127,sebsi:1  marzouki:1  
22,8,5,100,1,523,405,600,1,194,405,600,0,0,394,9,2,405,0,1810,1900,True,286,108,sebsi:1  marzouki:1  
22,8,4,99,3,493,209,600,0,391,209,600,0,0,203,3,3,209,0,1818,1850,True,140,63,sebsi:1  marzouki:1  
22,8,4,99,2,493,270,600,2,328,270,600,0,0,265,4,1,270,0,1830,1900,True,201,64,sebsi:1  marzouki:1  
22,8,4,99,1,493,316,600,1,283,316,600,0,0,289,24,3,316,0,1815,1915,True,232,57,sebsi:1  marzouki:1  
22,8,4,98,4,530,261,600,0,339,261,600,0,0,254,6,1,261,0,1820,,True,169,85,sebsi:1  marzouki:1  
22,8,4,98,3,532,319,600,0,283,317,600,0,2,314,3,0,317,0,1810,1845,True,221,93,sebsi:1  marzouki:1  
22,8,4,98,2,532,368,600,0,232,368,600,0,0,359,3,6,368,0,1810,1855,True,264,95,sebsi:1  marzouki:1  
22,8,4,98,1,532,377,600,0,223,377,600,0,0,371,4,2,377,0,1800,1845,True,276,95,sebsi:1  marzouki:1  
22,8,4,97,4,575,357,704,1,346,357,704,0,0,352,3,2,357,0,1810,1900,True,192,160,sebsi:1  marzouki:1  
22,8,4,97,3,578,363,700,0,337,363,700,0,0,360,2,1,363,0,1820,1915,True,211,149,sebsi:1  marzouki:1  
22,8,4,97,2,578,446,700,0,254,446,700,0,0,443,2,1,446,0,1830,1930,True,234,209,sebsi:1  marzouki:1  
22,8,4,97,1,578,427,700,2,271,427,700,0,0,419,7,1,427,0,1805,1931,True,268,151,sebsi:1  marzouki:1  
22,8,4,96,4,548,259,600,0,341,259,600,0,0,250,5,4,259,0,1820,1900,True,184,66,sebsi:1  marzouki:1  
22,8,4,96,3,549,321,600,2,277,321,600,0,0,313,3,5,321,0,1815,1900,True,242,71,sebsi:1  marzouki:1  
22,8,4,96,2,549,394,600,1,205,394,600,0,0,389,3,2,394,0,1834,1941,True,274,115,sebsi:1  marzouki:1  
22,8,4,96,1,549,383,600,2,215,383,600,0,0,374,8,1,383,0,1800,1915,True,309,65,sebsi:1  marzouki:1  
22,8,3,95,6,503,277,600,0,323,277,600,0,0,272,2,3,277,0,1830,1900,True,178,94,sebsi:1  marzouki:1  
22,8,3,95,5,505,286,600,0,314,286,600,0,0,283,1,2,286,0,1820,1900,True,197,86,sebsi:1  marzouki:1  
22,8,3,95,4,505,357,600,0,243,357,600,0,0,350,3,4,357,0,1815,1900,True,238,112,sebsi:1  marzouki:1  
22,8,3,95,3,505,363,600,0,237,363,600,0,0,357,0,6,363,0,1815,1910,True,209,148,sebsi:1  marzouki:1  
22,8,3,95,2,505,397,600,0,203,397,600,0,0,393,4,0,397,0,1815,1915,True,277,116,sebsi:1  marzouki:1  
22,8,3,95,1,505,401,600,0,199,401,600,0,0,396,2,3,401,0,1800,1905,True,303,93,sebsi:1  marzouki:1  
22,8,3,94,4,466,276,500,2,222,276,500,0,0,269,4,3,276,0,1814,1906,True,195,74,sebsi:1  marzouki:1  
22,8,3,94,3,466,330,500,0,170,330,500,0,0,326,4,0,330,0,1820,1925,True,242,84,sebsi:1  marzouki:1  
22,8,3,94,2,466,348,500,0,152,348,500,0,0,338,9,1,348,0,180,1933,True,229,109,sebsi:1  marzouki:1  
22,8,3,94,1,466,367,500,1,132,367,500,0,0,349,15,3,367,0,1830,1930,True,284,65,sebsi:1  marzouki:1  
22,8,3,93,5,494,213,600,1,386,213,600,0,0,211,2,0,213,0,1830,1915,True,142,69,sebsi:1  marzouki:1  
22,8,3,93,4,497,298,600,1,301,298,600,0,0,294,3,1,298,0,1820,1915,True,234,60,sebsi:1  marzouki:1  
22,8,3,93,3,497,317,600,0,283,317,600,0,0,310,7,0,317,0,1810,1909,True,234,76,sebsi:1  marzouki:1  
22,8,3,93,2,497,359,600,1,240,359,600,0,0,353,6,0,359,0,1815,1920,True,299,54,sebsi:1  marzouki:1  
22,8,3,93,1,497,337,600,0,263,337,600,0,0,331,3,3,337,0,1800,1915,True,278,53,sebsi:1  marzouki:1  
22,8,2,92,1,451,260,500,4,236,260,500,0,0,256,3,1,260,0,1815,1849,True,200,56,sebsi:1  marzouki:1  
22,8,1,91,4,528,304,600,1,295,304,600,0,0,297,3,4,304,0,1800,1900,True,182,115,sebsi:1  marzouki:1  
22,8,1,91,3,531,322,600,0,278,322,600,0,0,313,5,4,322,0,1805,1850,True,195,118,sebsi:1  marzouki:1  
22,8,1,91,1,531,384,600,2,214,384,600,0,0,371,7,6,384,0,1825,2030,True,265,106,sebsi:1  marzouki:1  
22,8,1,90,5,525,287,600,5,309,286,600,0,1,281,4,1,286,0,1830,1928,True,187,94,sebsi:1  marzouki:1  
22,8,1,90,4,526,316,600,0,284,316,600,0,0,305,6,5,316,0,1810,1910,True,196,109,sebsi:1  marzouki:1  
22,8,1,90,3,526,353,600,0,247,353,600,0,0,351,2,0,353,0,1812,1905,True,220,131,sebsi:1  marzouki:1  
22,8,1,90,2,526,408,600,2,190,408,600,0,0,400,8,0,408,0,1805,1922,True,284,116,sebsi:1  marzouki:1  
22,8,1,90,1,526,391,600,0,209,391,600,0,0,380,7,4,391,0,1820,1902,True,301,79,sebsi:1  marzouki:1  
22,7,4,89,1,76,39,100,0,61,39,100,0,0,37,2,0,39,0,1805,1830,True,23,14,sebsi:1  marzouki:1  
22,7,4,88,3,441,190,501,0,311,190,501,0,0,183,2,5,190,0,180,1840,True,116,67,sebsi:1  marzouki:1  
22,7,4,88,2,442,214,500,0,286,214,500,0,0,210,2,2,214,0,1815,1900,True,149,61,sebsi:1  marzouki:1  
22,7,4,88,1,442,274,500,2,224,274,500,0,0,263,7,4,274,0,1810,1850,False,196,67,sebsi:1  marzouki:1  
22,7,3,87,1,307,181,400,1,217,181,399,1,0,175,3,3,181,0,1805,1911,True,145,30,sebsi:1  marzouki:1  
22,7,3,86,2,380,121,400,0,279,121,400,0,0,121,0,0,121,0,1800,1827,True,95,26,sebsi:1  marzouki:1  
22,7,3,86,1,380,186,400,0,214,186,400,0,0,178,2,6,186,0,1809,1845,True,150,28,sebsi:1  marzouki:1  
22,7,2,85,4,558,325,600,1,274,325,600,0,0,313,3,9,325,0,1800,1909,True,254,59,sebsi:1  marzouki:1  
22,7,2,85,3,560,374,600,1,225,374,600,0,0,371,1,2,374,0,1815,1915,True,294,77,sebsi:1  marzouki:1  
22,7,2,85,2,560,430,600,0,170,430,600,0,0,425,1,4,430,0,1800,1840,True,334,91,sebsi:1  marzouki:1  
22,7,2,85,1,560,418,600,0,182,418,600,0,0,391,16,11,418,0,1830,1910,True,331,60,sebsi:1  marzouki:1  
22,7,1,84,4,503,304,602,1,298,303,602,0,1,296,4,3,303,0,1820,1919,True,241,55,sebsi:1  marzouki:1  
22,7,1,84,3,503,348,600,1,251,348,600,0,0,341,3,4,348,0,1815,1923,True,277,64,sebsi:1  marzouki:1  
22,7,1,84,2,503,392,600,1,207,392,600,0,0,386,2,4,392,0,1820,1910,True,311,75,sebsi:1  marzouki:1  
22,7,1,84,1,503,382,601,6,213,382,601,0,0,370,5,7,382,0,1815,1915,True,313,57,sebsi:1  marzouki:1  
22,6,6,83,2,368,251,400,1,148,251,400,0,0,248,1,2,251,0,1810,1852,True,150,98,sebsi:1  marzouki:1  
22,6,6,83,1,369,278,400,0,122,278,400,0,0,274,3,1,278,0,1825,1855,True,164,110,sebsi:1  marzouki:1  
22,6,5,82,3,513,247,603,1,355,247,603,0,0,236,6,5,247,0,1817,1900,True,162,74,sebsi:1  marzouki:1  
22,6,5,82,2,515,319,600,2,279,319,600,0,0,308,8,3,319,0,1820,1905,True,221,87,sebsi:1  marzouki:1  
22,6,5,82,1,515,374,600,1,225,374,600,0,0,356,14,4,374,0,1800,1924,True,281,75,sebsi:1  marzouki:1  
22,6,4,80,2,306,145,400,0,255,145,400,0,0,142,2,1,145,0,1805,1855,True,75,67,sebsi:1  marzouki:1  
22,6,4,80,1,307,207,400,3,190,207,400,0,0,203,2,2,207,0,1800,1842,True,125,78,sebsi:1  marzouki:1  
22,6,4,79,8,537,288,600,0,312,288,600,0,0,285,2,1,288,0,1820,1910,True,98,187,sebsi:1  marzouki:1  
22,6,4,79,7,542,289,600,0,311,289,600,0,0,280,5,4,289,0,1815,1918,True,91,189,sebsi:1  marzouki:1  
22,6,4,79,5,542,367,600,0,233,367,600,0,0,358,9,0,367,0,1830,1930,True,123,235,sebsi:1  marzouki:1  
22,6,4,79,4,542,378,600,0,222,378,600,0,0,368,8,2,378,0,1830,1930,True,140,228,sebsi:1  marzouki:1  
22,6,4,79,3,542,432,600,1,167,432,600,0,0,418,10,4,432,0,1830,1915,True,155,263,sebsi:1  marzouki:1  
22,6,4,79,2,542,365,592,1,226,365,592,0,0,352,7,6,365,0,1830,1940,True,155,197,sebsi:1  marzouki:1  
22,6,4,79,1,542,403,600,1,196,403,600,0,0,397,5,1,403,0,1830,1917,True,245,152,sebsi:1  marzouki:1  
22,6,3,78,2,470,271,500,0,229,271,500,0,0,270,0,1,271,0,1810,1850,True,219,51,sebsi:1  marzouki:1  
22,6,3,78,1,470,350,500,0,150,350,500,0,0,340,10,0,350,0,1815,1935,False,286,54,sebsi:1  marzouki:1  
22,6,2,77,3,578,313,701,0,388,313,701,0,0,309,1,3,313,0,1800,1855,True,188,121,sebsi:1  marzouki:1  
22,6,2,77,2,578,375,700,0,325,375,700,0,0,367,4,4,375,0,1800,1915,True,240,127,sebsi:1  marzouki:1  
22,6,2,77,1,578,446,700,2,252,446,700,0,0,429,10,7,446,0,1830,1925,True,298,131,sebsi:1  marzouki:1  
22,6,1,76,4,567,322,600,0,278,322,600,0,0,314,6,2,322,0,1805,1930,True,216,98,sebsi:1  marzouki:1  
22,6,1,76,3,567,347,600,2,251,347,600,0,0,345,1,1,347,0,1830,1915,True,208,137,sebsi:1  marzouki:1  
22,6,1,76,2,567,425,599,2,172,425,599,0,0,416,7,2,425,0,1800,1930,True,285,131,sebsi:1  marzouki:1  
22,6,1,76,1,567,398,600,1,201,398,600,0,0,389,6,3,398,0,1820,1925,True,308,81,sebsi:1  marzouki:1  
22,6,1,75,3,506,289,598,0,309,289,598,0,0,277,10,2,289,0,1820,1905,True,198,79,sebsi:1  marzouki:1  
22,6,1,75,2,506,354,600,2,244,354,600,0,0,345,3,6,354,0,1815,1900,True,214,131,sebsi:1  marzouki:1  
22,6,1,75,1,506,371,600,2,227,371,600,0,0,353,13,5,371,0,1815,1920,True,265,88,sebsi:1  marzouki:1  
22,1,3,7,1,290,201,392,0,191,201,392,0,0,193,7,1,201,0,1822,1918,True,153,40,sebsi:1  marzouki:1  
22,1,2,6,1,421,281,500,1,219,280,500,0,1,278,2,0,280,0,1815,1915,True,181,97,sebsi:1  marzouki:1  
22,1,2,5,3,443,219,500,0,281,219,500,0,0,217,0,2,219,0,1808,1906,True,123,94,sebsi:1  marzouki:1  
22,1,2,5,2,444,296,501,0,205,296,501,0,0,291,4,1,296,0,1810,1856,True,196,95,sebsi:1  marzouki:1  
22,1,2,5,1,444,325,501,0,176,325,501,0,0,317,6,2,325,0,1830,1900,True,209,108,sebsi:1  marzouki:1  
22,1,2,4,2,529,345,600,0,255,345,600,0,0,336,4,5,345,0,1805,1935,True,241,95,sebsi:1  marzouki:1  
22,1,2,4,1,529,392,600,2,206,392,600,0,0,380,10,2,392,0,1820,1915,True,275,105,sebsi:1  marzouki:1  
22,1,1,3,1,310,203,400,0,197,203,400,0,0,201,2,0,203,0,1815,1848,True,138,63,sebsi:1  marzouki:1  
22,1,1,2,1,540,390,600,1,209,390,600,0,0,385,3,2,390,0,1830,1900,True,327,58,sebsi:1  marzouki:1  
22,1,1,1,7,557,300,600,0,300,300,600,0,0,289,2,9,300,0,1807,1855,True,196,93,sebsi:1  marzouki:1  
22,1,1,1,6,561,332,600,0,268,332,600,0,0,320,7,5,332,0,,1915,True,203,117,sebsi:1  marzouki:1  
22,1,1,1,5,561,324,600,0,276,324,600,0,0,322,2,0,324,0,1815,1905,False,249,73,sebsi:1  marzouki:1  
22,1,1,1,4,561,372,602,0,230,372,602,0,0,366,3,3,372,0,1810,1900,True,277,89,sebsi:1  marzouki:1  
22,1,1,1,3,561,405,600,0,195,405,600,0,0,395,6,4,405,0,1815,2000,True,284,111,sebsi:1  marzouki:1  
22,1,1,1,2,561,333,600,0,267,333,600,0,0,326,5,2,333,0,1810,1853,True,259,67,sebsi:1  marzouki:1  
22,1,1,1,1,561,409,600,1,190,409,600,0,0,395,7,7,409,0,1813,1855,True,307,88,sebsi:1  marzouki:1  
