circonscriptionId,delegationId,subDelegationId,centerID,stationId,registeredVoters,aSigningVoters,bDeliveredBallots,cSpoiledBallots,dLeftBallots,fExtractedBallots,gEplusF,hBminusG,iAminusF,jListVotes,kCancelledVotes,lBlankVotes,mJplusKplusL,nFminusM,countingStart,countingEnd,tampon,sebsi,marzouki,observers
4,4,4,59,4,530,307,600,3,290,307,600,0,0,300,5,2,307,0,1800,1928,True,147,153,sebsi:1  marzouki:1  
4,4,4,59,3,533,307,600,0,293,307,600,0,0,303,4,0,307,0,1815,1910,True,164,139,sebsi:1  marzouki:1  
4,4,4,59,2,533,350,600,0,250,350,600,0,0,344,0,6,350,0,1815,1921,True,186,158,sebsi:1  marzouki:1  
4,4,4,59,1,533,395,600,0,205,395,600,0,0,386,7,2,395,0,1818,1911,True,234,152,sebsi:1  marzouki:1  
4,4,4,58,3,520,252,600,0,348,252,600,0,0,246,3,3,252,0,1810,1900,True,148,98,sebsi:1  marzouki:1  
4,4,4,58,2,521,329,600,0,271,329,600,0,0,323,4,2,329,0,1830,1930,True,190,133,sebsi:1  marzouki:1  
4,4,4,58,1,521,367,600,0,233,367,600,0,0,352,8,7,367,0,1815,1935,True,254,98,sebsi:1  marzouki:1  
4,4,3,57,7,531,329,602,0,273,329,602,0,0,324,4,1,329,0,1820,1920,True,155,169,sebsi:1  marzouki:1  
4,4,3,57,6,535,303,600,0,297,303,600,0,0,293,6,4,303,0,1810,1855,True,142,151,sebsi:1  marzouki:1  
4,4,3,57,5,535,299,600,2,299,299,600,0,0,292,2,5,299,0,1805,1843,True,145,147,sebsi:1  marzouki:1  
4,4,3,57,4,535,351,600,2,247,351,600,0,0,346,2,3,351,0,1815,1900,True,164,182,sebsi:1  marzouki:1  
4,4,3,57,3,535,360,596,0,236,360,596,0,0,350,4,6,360,0,1820,1900,False,189,161,sebsi:1  marzouki:1  
4,4,3,57,2,535,363,599,2,234,363,599,0,0,352,7,4,363,0,1815,1900,True,206,146,sebsi:1  marzouki:1  
4,4,3,57,1,535,376,600,2,222,376,600,0,0,369,5,2,376,0,1815,1920,True,242,127,sebsi:1  marzouki:1  
4,4,3,56,6,597,329,700,0,371,329,700,0,0,326,3,0,329,0,1815,1900,True,105,221,sebsi:1  marzouki:1  
4,4,3,56,5,600,313,700,0,387,313,700,0,0,309,2,2,313,0,1815,1900,True,121,188,sebsi:1  marzouki:1  
4,4,3,56,4,600,353,700,0,347,353,700,0,0,353,0,0,353,0,1810,1900,True,116,237,sebsi:1  marzouki:1  
4,4,3,56,3,600,381,700,1,318,381,700,0,0,372,7,2,381,0,1800,1900,True,163,209,sebsi:1  marzouki:1  
4,4,3,56,2,600,408,700,1,291,408,700,0,0,400,8,0,408,0,1800,1940,True,193,207,sebsi:1  marzouki:2  
4,4,3,56,1,600,440,700,1,259,440,700,0,0,433,7,0,440,0,1815,1925,True,199,234,sebsi:1  marzouki:1  
4,4,3,55,2,332,179,400,0,221,179,400,0,0,176,2,1,179,0,1815,1840,True,102,74,sebsi:1  marzouki:1  
4,4,3,55,1,332,219,400,1,180,219,400,0,0,213,5,1,219,0,1805,1850,True,136,77,sebsi:1  marzouki:1  
4,4,2,54,8,561,328,600,1,271,328,600,0,0,319,3,6,328,0,1830,1920,True,176,143,sebsi:1  marzouki:1  
4,4,2,54,7,566,331,600,1,268,331,600,0,0,326,5,0,331,0,1830,1930,True,193,133,sebsi:1  marzouki:1  
4,4,2,54,6,566,362,602,0,240,362,602,0,0,348,5,9,362,0,1853,2040,False,221,127,sebsi:1  marzouki:1  
4,4,2,54,5,566,339,600,0,261,339,600,0,0,331,4,4,339,0,1825,1906,True,205,126,sebsi:1  marzouki:1  
4,4,2,54,4,566,377,600,1,222,377,600,0,0,372,4,1,377,0,1819,1911,True,197,175,sebsi:1  marzouki:1  
4,4,2,54,3,566,391,600,0,209,391,600,0,0,386,2,3,391,0,1815,1922,True,237,149,sebsi:1  marzouki:1  
4,4,2,54,2,566,411,600,1,188,411,600,0,0,401,5,5,411,0,1835,,True,274,127,sebsi:1  marzouki:1  
4,4,2,53,2,599,472,700,0,228,472,700,0,0,465,3,4,472,0,1845,2010,True,311,154,sebsi:1  marzouki:1  
4,4,2,53,1,599,460,700,2,238,460,700,0,0,450,9,1,460,0,1845,2025,True,331,119,sebsi:1  marzouki:1  
4,4,2,52,7,514,350,600,0,250,350,600,0,0,340,2,8,350,0,1810,1916,False,201,139,sebsi:1  marzouki:1  
4,4,2,52,6,517,358,600,0,242,358,600,0,0,337,14,7,358,0,1815,1930,True,181,156,sebsi:1  marzouki:1  
4,4,2,52,5,517,361,600,1,238,361,600,0,0,350,6,5,361,0,1815,1920,False,204,146,sebsi:1  marzouki:1  
4,4,2,52,4,517,406,599,1,192,406,599,0,0,398,5,3,406,0,1820,1942,True,239,159,sebsi:1  marzouki:1  
4,4,2,52,3,517,404,601,0,197,404,601,0,0,395,6,3,404,0,1830,1915,True,251,144,sebsi:1  marzouki:1  
4,4,2,52,2,517,399,600,0,201,399,600,0,0,392,6,1,399,0,1812,1909,True,256,136,sebsi:1  marzouki:1  
4,4,2,52,1,517,437,604,0,167,437,604,0,0,428,7,2,437,0,1815,1930,True,314,114,sebsi:1  marzouki:1  
4,4,2,51,7,573,416,700,0,284,416,700,0,0,398,12,6,416,0,1830,1945,True,277,121,sebsi:1  marzouki:1  
4,4,2,51,6,573,416,692,3,273,416,692,0,0,404,6,6,416,0,1830,1920,True,288,116,sebsi:1  marzouki:1  
4,4,2,51,5,573,422,700,1,277,422,700,0,0,415,5,2,422,0,1830,1950,True,251,164,sebsi:1  marzouki:1  
4,4,2,51,4,573,470,687,0,217,470,687,0,0,458,8,4,470,0,1830,1930,True,297,161,sebsi:1  marzouki:1  
4,4,2,51,3,573,492,700,2,206,492,700,0,0,484,6,2,492,0,1840,2040,True,339,145,sebsi:1  marzouki:1  
4,4,2,51,1,573,494,700,0,206,494,700,0,0,480,5,9,494,0,1802,1920,True,386,94,sebsi:1  marzouki:1  
4,4,2,50,7,577,419,700,0,281,419,700,0,0,406,6,7,419,0,1820,1915,True,234,172,sebsi:1  marzouki:1  
4,4,2,50,6,579,403,703,0,300,403,703,0,0,377,14,12,403,0,1800,1915,False,199,178,sebsi:1  marzouki:1  
4,4,2,50,5,579,431,696,0,265,431,696,0,0,426,0,5,431,0,1815,1905,False,222,204,sebsi:1  marzouki:1  
4,4,2,50,4,579,456,700,3,241,456,700,0,0,453,3,0,456,0,1800,1930,True,262,191,sebsi:1  marzouki:1  
4,4,2,50,3,579,504,700,0,196,504,700,0,0,493,5,6,504,0,1810,,False,275,218,sebsi:1  marzouki:1  
4,4,2,50,2,579,480,700,0,220,480,700,0,0,462,15,3,480,0,1815,1930,True,302,160,sebsi:1  marzouki:1  
4,4,2,50,1,579,499,700,0,201,499,700,0,0,495,2,2,499,0,1815,1920,True,347,148,sebsi:1  marzouki:1  
4,4,1,49,6,541,280,596,0,316,280,596,0,0,274,3,3,280,0,1815,1914,False,136,138,sebsi:1  marzouki:1  
4,4,1,49,5,541,250,600,4,346,250,600,0,0,241,5,4,250,0,1805,1850,True,126,115,sebsi:1  marzouki:1  
4,4,1,49,4,541,266,599,0,333,266,599,0,0,260,3,3,266,0,1815,1900,True,142,118,sebsi:1  marzouki:1  
4,4,1,49,3,541,348,601,0,253,348,601,0,0,338,8,2,348,0,1840,1950,True,193,145,sebsi:1  marzouki:1  
4,4,1,49,2,541,353,601,3,245,353,601,0,0,345,5,3,353,0,1815,1900,False,228,117,sebsi:1  marzouki:2  
4,4,1,49,1,541,380,600,1,219,380,600,0,0,368,10,2,380,0,1810,1853,False,253,115,sebsi:1  marzouki:1  
4,4,1,48,8,560,316,600,0,284,316,600,0,0,315,1,0,316,0,1830,1920,False,147,168,sebsi:1  marzouki:1  
4,4,1,48,2,563,423,600,1,176,423,600,0,0,412,5,6,423,0,,2000,True,240,172,sebsi:1  marzouki:1  
4,4,1,48,1,563,413,599,4,182,413,599,0,0,405,5,3,413,0,,2000,True,250,155,sebsi:1  marzouki:1  
4,2,3,36,2,468,251,500,3,246,251,500,0,0,242,8,1,251,0,1810,1900,True,136,106,sebsi:1  marzouki:1  
4,2,3,36,1,468,363,500,0,137,363,500,0,0,354,6,3,363,0,1800,1910,True,175,179,sebsi:1  marzouki:1  
4,2,3,35,2,490,213,600,0,387,213,600,0,0,210,2,1,213,0,1814,1850,False,95,115,sebsi:1  marzouki:1  
4,2,3,35,1,491,276,600,0,324,276,600,0,0,270,5,1,276,0,1823,1930,True,160,110,sebsi:1  marzouki:1  
4,2,3,34,6,507,210,600,0,390,210,600,0,0,205,3,2,210,0,1830,1930,True,93,112,sebsi:1  marzouki:1  
4,2,3,34,5,512,216,600,0,384,216,600,0,0,212,2,2,216,0,1815,1900,False,107,105,sebsi:1  marzouki:1  
4,2,3,34,4,512,287,600,0,313,287,600,0,0,281,6,0,287,0,1805,1845,True,157,124,sebsi:1  marzouki:1  
4,2,3,34,3,512,298,600,0,302,298,600,0,0,287,4,7,298,0,1810,1855,False,158,129,sebsi:1  marzouki:1  
4,2,3,34,2,512,325,600,0,275,325,600,0,0,317,3,5,325,0,1830,1915,True,189,128,sebsi:1  marzouki:1  
4,2,3,34,1,512,313,603,1,289,313,603,0,0,303,7,3,313,0,1800,1855,True,195,108,sebsi:1  marzouki:1  
4,2,3,33,4,512,220,600,0,380,220,600,0,0,215,5,0,220,0,1832,1921,False,80,135,sebsi:1  marzouki:1  
4,2,3,33,3,513,263,600,1,336,263,600,0,0,253,7,3,263,0,1826,1922,True,106,147,sebsi:1  marzouki:1  
4,2,3,33,2,513,303,600,0,297,303,600,0,0,295,2,6,303,0,1825,1935,True,152,143,sebsi:1  marzouki:1  
4,2,2,32,3,477,221,600,1,378,221,600,0,0,217,3,1,221,0,1818,1851,True,80,137,sebsi:1  marzouki:1  
4,2,2,32,2,479,274,600,0,326,274,600,0,0,268,5,1,274,0,1805,1850,True,117,151,sebsi:1  marzouki:1  
4,2,2,32,1,479,313,601,1,287,313,601,0,0,305,7,1,313,0,1830,1914,False,162,143,sebsi:1  marzouki:1  
4,2,1,31,2,552,293,596,1,302,293,596,0,0,286,4,3,293,0,1815,1905,True,130,156,sebsi:1  marzouki:0  
4,2,1,31,1,552,362,600,0,238,362,600,0,0,351,3,8,362,0,1820,1900,True,187,164,sebsi:1  marzouki:1  
4,2,1,30,1,325,243,400,0,157,243,400,0,0,240,2,1,243,0,1800,1900,True,159,81,sebsi:1  marzouki:1  
4,2,1,29,2,392,226,500,2,272,226,500,0,0,219,5,2,226,0,1815,1900,True,118,101,sebsi:1  marzouki:1  
4,2,1,29,1,393,285,500,0,215,285,500,0,0,279,5,1,285,0,1815,1855,True,162,117,sebsi:1  marzouki:1  
4,2,1,28,6,527,253,600,2,345,253,600,0,0,241,9,3,253,0,1815,1900,True,108,133,sebsi:1  marzouki:1  
4,2,1,28,5,529,230,600,1,369,230,600,0,0,225,1,4,230,0,1827,1848,False,99,126,sebsi:1  marzouki:1  
4,2,1,28,4,529,320,600,0,280,320,600,0,0,314,1,5,320,0,1830,1900,False,139,175,sebsi:1  marzouki:1  
4,2,1,28,3,529,309,600,0,291,309,600,0,0,301,8,0,309,0,1810,1835,False,148,153,sebsi:1  marzouki:1  
4,2,1,28,2,529,343,600,0,257,343,600,0,0,330,4,9,343,0,1805,1836,True,172,158,sebsi:1  marzouki:1  
4,2,1,28,1,529,367,600,0,233,367,600,0,0,356,5,6,367,0,1815,1910,False,213,143,sebsi:1  marzouki:1  
4,2,1,27,5,506,193,602,0,409,193,602,0,0,190,1,2,193,0,1800,1849,False,73,117,sebsi:1  :1  
4,2,1,27,4,506,243,600,0,357,243,600,0,0,236,2,5,243,0,1820,1900,True,105,131,sebsi:1  marzouki:1  
4,2,1,27,3,506,282,600,0,318,282,600,0,0,276,4,2,282,0,1815,1845,True,141,135,sebsi:1  marzouki:1  
4,2,1,27,2,506,294,600,0,306,294,600,0,0,286,7,1,294,0,1800,1845,True,153,133,sebsi:1  marzouki:1  
4,2,1,27,1,506,331,600,2,267,331,600,0,0,319,5,7,331,0,1805,1903,True,183,136,sebsi:1  marzouki:1  
4,2,1,26,5,572,321,700,3,376,321,700,0,0,312,5,4,321,0,1830,1940,True,131,181,sebsi:1  marzouki:1  
4,2,1,26,4,575,276,700,0,424,276,700,0,0,265,6,5,276,0,1813,1907,False,130,135,sebsi:1  marzouki:1  
4,2,1,26,3,575,376,700,0,324,376,700,0,0,372,3,1,376,0,1815,1900,False,181,191,sebsi:1  :1  
4,2,1,25,5,560,285,601,0,316,285,601,0,0,280,2,3,285,0,,1930,False,149,131,sebsi:1  marzouki:1  
4,2,1,25,4,561,318,599,0,281,318,599,0,0,312,4,2,318,0,1830,1925,True,155,157,sebsi:1  marzouki:1  
4,2,1,25,3,561,374,600,0,226,374,600,0,0,364,6,4,374,0,1830,1930,True,187,177,sebsi:1  marzouki:1  
4,2,1,25,2,561,393,600,2,205,393,600,0,0,384,4,5,393,0,1830,1945,True,226,158,sebsi:0  marzouki:1  
4,2,1,25,1,561,416,600,0,184,416,600,0,0,405,5,6,416,0,1835,1945,False,277,128,sebsi:1  marzouki:1  
4,5,5,68,3,551,422,600,0,178,422,600,0,0,406,12,4,422,0,1835,1936,True,252,154,sebsi:1  marzouki:1  
4,5,5,68,2,551,441,600,1,158,441,600,0,0,433,6,2,441,0,1835,1955,True,295,138,sebsi:1  marzouki:1  
4,5,4,67,2,524,386,600,3,211,386,600,0,0,383,2,1,386,0,1815,1910,True,276,107,sebsi:1  marzouki:1  
4,5,4,67,1,524,418,604,1,185,418,604,0,0,399,10,9,418,0,1825,1945,True,304,95,sebsi:1  marzouki:1  
4,5,3,66,6,531,352,600,0,248,352,600,0,0,348,2,2,352,0,,1932,False,221,127,sebsi:1  marzouki:1  
4,5,3,66,5,532,291,600,1,308,291,600,0,0,283,5,3,291,0,1830,1940,False,157,126,sebsi:1  marzouki:1  
4,5,3,66,4,532,367,600,0,233,367,600,0,0,357,3,7,367,0,1838,1935,True,205,152,sebsi:1  marzouki:1  
4,5,3,66,3,532,372,600,0,228,372,600,0,0,363,6,3,372,0,1830,1952,False,210,153,sebsi:1  marzouki:1  
4,5,3,66,2,532,385,600,4,211,385,600,0,0,370,9,6,385,0,1830,1955,False,263,107,sebsi:1  marzouki:1  
4,5,3,66,1,532,420,600,1,179,420,600,0,0,402,16,2,420,0,,1925,False,306,96,sebsi:1  marzouki:1  
4,5,2,65,7,579,309,684,0,375,309,684,0,0,304,2,3,309,0,1830,1915,True,183,121,sebsi:1  marzouki:1  
4,5,2,65,6,581,315,700,1,384,315,700,0,0,310,3,2,315,0,1800,1845,True,170,140,sebsi:1  marzouki:1  
4,5,2,65,5,581,340,700,3,357,340,700,0,0,335,3,2,340,0,1820,1915,False,174,161,marzouki:1  :1  
4,5,2,65,4,581,385,700,0,315,385,700,0,0,379,4,2,385,0,,,True,245,134,sebsi:1  marzouki:1  
4,5,2,65,3,581,418,700,1,281,418,700,0,0,410,5,3,418,0,1825,1925,True,246,164,marzouki:1  :1  
4,5,2,65,2,581,403,714,0,311,403,714,14,0,391,8,4,403,0,1815,1935,True,245,146,sebsi:1  marzouki:1  
4,5,2,65,1,581,455,700,0,245,455,700,0,0,447,5,3,455,0,1830,1945,True,293,154,sebsi:1  marzouki:1  
4,5,2,64,7,584,261,700,0,439,261,700,0,0,256,4,1,261,0,1815,1910,False,151,105,sebsi:1  marzouki:1  
4,5,2,64,6,586,278,700,0,422,278,700,0,0,274,2,2,278,0,1815,1855,True,162,112,sebsi:1  marzouki:1  
4,5,2,64,5,586,301,700,0,399,301,700,0,0,290,7,4,301,0,1805,1845,True,185,105,sebsi:1  marzouki:1  
4,5,2,64,4,586,386,668,1,281,386,668,0,0,378,8,0,386,0,1820,1915,False,220,158,sebsi:1  marzouki:1  
4,5,2,64,3,586,377,700,0,323,377,700,0,0,369,5,3,377,0,1800,1846,False,233,136,sebsi:1  marzouki:1  
4,5,2,64,2,586,412,684,0,272,412,684,0,0,396,13,3,412,0,1825,1945,True,242,154,sebsi:1  marzouki:1  
4,5,2,64,1,586,411,700,0,289,411,700,0,0,399,4,8,411,0,1805,1928,True,289,110,sebsi:1  :1  
4,5,1,63,3,450,260,500,1,239,260,0,0,0,252,6,2,260,0,1815,1850,False,165,87,sebsi:1  :1  
4,5,1,63,2,450,285,500,2,213,285,500,0,0,279,5,1,285,0,1805,1840,False,184,95,sebsi:1  marzouki:1  
4,5,1,63,1,450,342,500,0,158,342,500,0,0,329,6,7,342,0,1845,1905,False,266,63,sebsi:1  marzouki:1  
4,5,1,62,7,586,351,700,0,349,351,700,0,0,341,6,4,351,0,1845,2000,True,206,135,sebsi:1  marzouki:1  
4,5,1,62,6,587,331,702,0,371,331,702,0,0,322,6,3,331,0,1815,1915,True,168,154,sebsi:1  marzouki:1  
4,5,1,62,5,587,354,700,0,346,354,700,0,0,342,10,2,354,0,1830,1940,False,181,161,sebsi:1  marzouki:1  
4,5,1,62,4,587,389,700,1,310,389,700,0,0,378,5,6,389,0,1830,1923,True,197,181,sebsi:1  marzouki:0  
4,5,1,62,3,587,412,687,0,275,412,687,0,0,403,4,5,412,0,1830,1930,True,225,178,sebsi:1  marzouki:0  
4,5,1,62,2,587,409,700,2,289,409,700,0,0,400,6,3,409,0,1815,1915,False,244,156,sebsi:1  marzouki:1  
4,5,1,61,6,517,337,600,0,263,337,600,0,0,328,4,5,337,0,1805,1910,False,230,98,sebsi:1  marzouki:1  
4,5,1,60,7,584,391,700,1,308,391,700,0,0,380,7,4,391,0,1815,1920,False,285,95,sebsi:1  marzouki:1  
4,5,1,60,6,584,417,699,1,281,417,699,0,0,409,3,5,417,0,1830,1945,False,290,119,sebsi:1  marzouki:1  
4,5,1,60,5,584,451,701,0,250,451,701,0,0,444,4,3,451,0,1820,1930,False,336,108,sebsi:1  marzouki:1  
4,5,1,60,4,584,459,700,0,241,459,700,0,0,448,7,4,459,0,1815,1910,True,363,85,sebsi:1  marzouki:1  
4,5,1,60,3,584,460,700,0,240,460,700,0,0,451,6,3,460,0,1815,1921,False,348,103,sebsi:1  marzouki:1  
4,5,1,60,2,584,482,700,2,216,482,700,0,0,471,6,5,482,0,1817,1915,False,367,104,sebsi:1  marzouki:1  
4,5,1,60,1,584,496,700,4,200,496,700,0,0,489,4,3,496,0,1820,1935,False,403,86,sebsi:1  marzouki:1  
4,3,5,47,5,548,222,600,0,378,222,600,0,0,216,3,3,222,0,1810,1852,True,93,123,sebsi:1  marzouki:0  
4,3,5,47,4,550,269,600,2,329,269,600,0,0,267,0,2,269,0,1810,1853,True,107,160,sebsi:1  marzouki:1  
4,3,5,47,3,550,311,600,1,288,311,600,0,0,304,2,5,311,0,1900,,False,146,158,sebsi:1  marzouki:1  
4,3,5,47,2,550,337,600,0,263,337,600,0,0,332,3,2,337,0,1805,1905,True,202,130,sebsi:1  marzouki:1  
4,3,5,47,1,550,359,600,2,239,359,600,0,0,344,15,0,359,0,1817,1922,True,213,131,sebsi:1  marzouki:1  
4,3,4,46,2,558,278,600,0,322,278,600,0,0,277,0,1,278,0,1815,1930,True,110,167,sebsi:1  marzouki:1  
4,3,4,46,1,559,359,600,3,238,359,600,0,0,352,7,0,359,0,1815,1900,True,194,158,sebsi:1  marzouki:1  
4,3,4,45,5,480,175,600,2,423,175,600,0,0,172,2,1,175,0,1800,1900,True,76,96,sebsi:1  marzouki:1  
4,3,4,45,4,481,212,600,0,388,212,600,0,0,211,0,1,212,0,,1845,True,74,137,sebsi:1  marzouki:1  
4,3,4,45,3,481,268,600,1,331,268,600,0,0,266,0,2,268,0,1815,1855,True,126,140,sebsi:1  marzouki:1  
4,3,4,45,2,481,275,600,0,325,275,600,0,0,268,1,6,275,0,1815,1900,True,147,121,sebsi:1  marzouki:1  
4,3,4,45,1,481,295,600,0,305,295,600,0,0,278,6,11,295,0,,1900,False,168,110,sebsi:1  marzouki:1  
4,3,3,44,7,593,237,700,0,463,237,700,0,0,233,2,2,237,0,1800,1930,True,100,133,sebsi:1  marzouki:1  
4,3,3,44,6,599,250,700,0,450,250,700,0,0,247,0,3,250,0,1815,1905,True,105,142,sebsi:1  marzouki:1  
4,3,3,44,5,599,288,700,0,412,288,700,0,0,282,3,3,288,0,1810,1905,True,116,166,sebsi:1  marzouki:1  
4,3,3,44,4,599,306,700,1,393,306,700,0,0,299,4,3,306,0,1825,1920,True,130,169,sebsi:1  marzouki:1  
4,3,3,44,3,599,324,700,2,374,324,700,0,0,313,3,8,324,0,1830,2018,True,148,165,sebsi:1  marzouki:1  
4,3,3,44,2,599,346,704,0,358,346,704,0,0,338,2,6,346,0,1815,1910,True,220,118,sebsi:1  marzouki:1  
4,3,3,44,1,599,358,699,0,341,358,699,0,0,345,10,3,358,0,1815,1915,True,201,144,sebsi:1  marzouki:1  
4,3,3,43,8,554,254,600,0,346,254,600,0,0,246,4,4,254,0,1810,1905,True,98,148,sebsi:1  marzouki:1  
4,3,3,43,7,559,268,600,0,332,268,600,0,0,261,3,4,268,0,1810,1855,True,94,167,sebsi:1  marzouki:1  
4,3,3,43,6,559,306,600,3,291,306,600,0,0,302,4,0,306,0,1817,1908,True,122,180,sebsi:1  marzouki:1  
4,3,3,43,5,559,372,600,3,226,371,600,0,1,362,9,0,371,0,1815,1910,True,153,209,sebsi:1  marzouki:1  
4,3,3,43,4,559,337,600,0,263,337,600,0,0,321,6,10,337,0,1824,1930,True,162,159,sebsi:1  marzouki:1  
4,3,3,43,3,559,351,600,1,248,351,600,0,0,347,1,3,351,0,1815,1910,True,184,163,sebsi:1  marzouki:1  
4,3,3,43,2,559,376,600,0,224,376,600,0,0,366,8,2,376,0,1815,1940,False,216,150,sebsi:1  marzouki:1  
4,3,3,43,1,559,374,596,1,221,374,596,0,0,361,6,7,374,0,1820,1920,True,222,139,sebsi:1  marzouki:1  
4,3,3,42,7,554,268,600,1,331,268,600,0,0,259,4,5,268,0,1810,1841,True,100,159,sebsi:1  marzouki:1  
4,3,3,42,6,558,267,609,0,342,267,609,0,0,259,4,4,267,0,1810,1904,True,91,168,sebsi:1  marzouki:0  
4,3,2,41,7,561,296,600,0,304,296,600,0,0,289,5,2,296,0,1815,1920,False,125,164,sebsi:1  marzouki:1  
4,3,2,41,6,563,255,600,0,345,255,600,0,0,249,2,4,255,0,1820,1855,True,89,160,sebsi:1  marzouki:1  
4,3,2,41,5,563,298,598,0,300,298,598,0,0,296,2,0,298,0,1810,1850,False,111,185,sebsi:1  marzouki:1  
4,3,2,41,4,563,337,600,4,259,337,600,0,0,334,2,1,337,0,1820,1910,True,138,196,sebsi:1  marzouki:0  
4,3,2,41,3,563,335,600,1,265,334,600,0,1,327,5,2,334,0,1815,1913,True,179,148,sebsi:1  marzouki:1  
4,3,2,41,2,563,384,600,3,213,384,600,0,0,368,13,3,384,0,1815,1951,True,212,156,sebsi:1  marzouki:0  
4,3,2,41,1,563,385,600,2,213,385,600,0,0,369,15,1,385,0,1800,1915,True,221,148,sebsi:1  marzouki:1  
4,3,1,40,4,531,198,600,0,402,198,600,0,0,192,2,4,198,0,1800,1900,True,100,92,sebsi:1  marzouki:1  
4,3,1,40,3,533,218,600,0,382,218,600,0,0,218,0,0,218,0,1800,1830,True,98,120,sebsi:1  marzouki:1  
4,3,1,40,2,533,270,600,0,330,270,600,0,0,265,5,0,270,0,1815,1900,True,150,115,sebsi:1  marzouki:0  
4,3,1,40,1,533,271,600,1,327,272,600,0,1,262,4,6,272,0,1800,1917,True,162,100,sebsi:1  marzouki:1  
4,3,1,39,6,540,228,600,2,370,228,600,0,0,218,5,5,228,0,1815,1900,False,110,108,sebsi:1  marzouki:1  
4,3,1,39,5,542,307,600,2,291,307,600,0,0,302,2,3,307,0,1815,1850,True,132,170,sebsi:0  marzouki:1  
4,3,1,39,4,542,323,600,0,277,323,600,0,0,314,4,5,323,0,1815,1856,True,138,176,sebsi:1  marzouki:1  
4,3,1,39,3,542,324,600,1,275,324,600,0,0,317,7,0,324,0,1810,1855,True,174,143,sebsi:1  marzouki:1  
4,3,1,39,2,542,351,600,1,249,350,600,0,1,337,5,8,350,0,1800,2000,True,200,137,sebsi:1  marzouki:1  
4,3,1,39,1,542,354,600,2,244,354,600,0,0,341,8,5,354,0,,1905,True,188,153,sebsi:1  marzouki:1  
4,3,1,38,3,572,205,700,1,494,205,700,0,0,201,2,2,205,0,1815,1910,True,95,106,sebsi:1  marzouki:1  
4,3,1,38,2,574,291,700,0,409,291,700,0,0,285,5,1,291,0,,1930,True,145,140,sebsi:1  marzouki:1  
4,3,1,38,1,574,321,700,0,379,321,700,0,0,308,6,7,321,0,1820,1900,True,176,132,sebsi:1  marzouki:1  
4,3,1,37,7,593,240,692,0,452,240,692,0,0,238,1,1,240,0,1800,1900,True,88,150,sebsi:1  marzouki:1  
4,3,1,37,6,596,272,700,2,426,272,700,0,0,266,3,3,272,0,1820,1900,True,109,157,sebsi:1  marzouki:1  
4,3,1,37,5,596,322,700,0,378,322,700,0,0,313,6,3,322,0,1830,1900,True,123,190,sebsi:1  marzouki:1  
4,3,1,37,3,596,340,684,0,344,340,684,0,0,333,7,0,340,0,1830,1903,True,185,148,sebsi:1  marzouki:1  
4,3,1,37,2,596,395,700,1,304,395,700,0,0,378,16,1,395,0,1813,1915,True,232,146,sebsi:1  marzouki:1  
4,3,1,37,1,596,391,700,0,309,391,700,0,0,380,9,2,391,0,1820,,True,251,129,sebsi:1  marzouki:1  
4,1,8,22,6,561,395,600,0,205,395,600,0,0,381,9,5,395,0,1820,1935,True,328,53,sebsi:1  marzouki:1  
4,1,8,22,5,563,404,600,0,196,404,600,0,0,398,3,3,404,0,1800,1950,True,333,65,sebsi:1  marzouki:1  
4,1,8,22,4,563,422,600,2,176,422,600,0,0,416,3,3,422,0,1836,1925,True,332,84,sebsi:1  marzouki:1  
4,1,8,22,3,563,442,600,0,158,442,600,0,0,434,3,5,442,0,1830,1945,True,354,80,sebsi:1  :1  
4,1,8,22,2,563,467,600,1,132,467,600,0,0,458,5,4,467,0,1812,1912,False,378,80,sebsi:1  :1  
4,1,8,22,1,563,484,600,1,115,484,600,0,0,471,3,10,484,0,1830,1930,True,409,62,sebsi:1  marzouki:1  
4,1,8,21,8,550,381,600,1,218,381,600,0,0,370,7,4,381,0,1825,1910,True,319,51,sebsi:1  marzouki:1  
4,1,8,21,7,556,421,600,0,179,421,600,0,0,407,7,7,421,0,1830,1945,True,349,58,sebsi:1  marzouki:1  
4,1,8,21,5,556,438,600,2,160,438,600,0,0,427,7,4,438,0,1830,2000,True,348,79,sebsi:1  marzouki:1  
4,1,8,21,4,556,436,600,0,164,436,600,0,0,432,2,2,436,0,1830,1945,True,364,68,sebsi:1  marzouki:1  
4,1,8,21,3,556,461,600,2,137,461,600,0,0,448,9,4,461,0,1825,1950,True,370,78,sebsi:1  marzouki:1  
4,1,8,21,2,556,474,601,0,127,474,601,0,0,463,8,3,474,0,1825,2000,True,398,65,sebsi:1  marzouki:1  
4,1,8,21,1,556,474,600,0,125,475,600,0,0,463,8,4,475,0,1835,2000,True,400,63,sebsi:1  marzouki:1  
4,1,8,20,8,566,433,600,1,166,433,600,0,0,420,5,8,433,0,1840,1935,True,364,56,sebsi:1  marzouki:1  
4,1,8,20,7,567,446,600,0,154,446,600,0,0,427,8,11,446,0,1845,1950,True,367,60,sebsi:1  marzouki:1  
4,1,8,20,6,567,438,609,0,171,438,609,0,0,422,5,11,438,0,1830,1930,True,357,65,sebsi:1  marzouki:1  
4,1,8,20,5,567,492,600,0,108,492,600,0,0,484,5,3,492,0,1830,2000,True,421,63,sebsi:1  marzouki:1  
4,1,8,20,4,567,494,584,1,90,493,584,0,1,486,6,1,493,0,1845,2025,True,395,91,sebsi:1  marzouki:1  
4,1,8,20,3,567,519,600,3,78,519,600,0,0,505,7,7,519,0,1835,2000,True,434,71,sebsi:1  marzouki:1  
4,1,8,20,2,567,513,600,0,87,513,600,0,0,505,4,4,513,0,1815,1935,False,456,49,sebsi:1  marzouki:1  
4,1,8,20,1,567,514,597,5,78,514,597,0,0,505,6,3,514,0,1845,2037,True,437,68,sebsi:1  marzouki:1  
4,1,8,19,7,562,451,600,1,148,451,600,0,0,439,9,3,451,0,1835,1923,False,402,37,sebsi:1  marzouki:1  
4,1,8,19,6,567,448,600,0,152,448,600,0,0,438,4,6,448,0,1830,1935,False,390,48,sebsi:1  marzouki:1  
4,1,8,19,5,567,489,600,0,111,489,600,0,0,482,3,4,489,0,1830,1939,False,403,79,sebsi:1  marzouki:1  
4,1,8,19,4,567,482,600,0,118,482,600,0,0,475,2,5,482,0,1830,1930,False,412,63,sebsi:1  marzouki:1  
4,1,8,19,3,567,507,584,2,75,507,584,0,0,504,3,0,507,0,1830,1935,False,408,96,sebsi:1  marzouki:1  
4,1,8,19,2,567,516,600,0,84,516,600,0,0,505,5,6,516,0,1830,1935,False,446,59,sebsi:1  marzouki:1  
4,1,8,19,1,567,517,598,2,79,517,598,0,0,506,6,5,517,0,1830,2000,True,453,53,sebsi:1  marzouki:1  
4,1,7,18,5,584,392,700,2,306,392,700,0,0,386,2,4,392,0,1800,1945,False,314,72,sebsi:1  marzouki:1  
4,1,7,18,4,586,420,700,1,279,420,700,0,0,410,5,5,420,0,1820,1934,True,328,82,sebsi:1  marzouki:1  
4,1,7,17,4,567,478,600,4,118,478,600,0,0,472,5,1,478,0,1830,1920,False,372,100,sebsi:1  marzouki:1  
4,1,7,17,3,567,492,600,0,108,492,600,0,0,483,3,6,492,0,1900,1948,False,385,98,sebsi:1  marzouki:1  
4,1,7,17,2,567,500,600,0,100,500,600,0,0,490,5,5,500,0,1825,1925,False,439,51,sebsi:1  marzouki:1  
4,1,7,17,1,567,504,601,2,95,504,601,0,0,493,9,2,504,0,1825,1950,False,456,37,sebsi:1  marzouki:1  
4,1,6,16,7,521,342,600,1,257,342,600,0,0,337,2,3,342,0,1815,1930,True,208,129,sebsi:1  marzouki:1  
4,1,6,16,5,522,362,600,0,238,362,600,0,0,358,3,1,362,0,1835,1905,True,197,161,sebsi:1  marzouki:1  
4,1,6,16,4,522,411,600,1,188,411,600,0,0,401,6,4,411,0,1830,1935,True,247,154,sebsi:1  marzouki:1  
4,1,6,16,3,522,411,600,0,189,411,600,0,0,401,3,7,411,0,1810,1851,False,260,141,sebsi:1  marzouki:1  
4,1,6,16,2,522,420,600,0,180,420,600,0,0,406,12,2,420,0,1815,1925,True,290,116,sebsi:1  marzouki:1  
4,1,6,16,1,522,439,600,2,159,439,600,0,0,425,9,5,439,0,1820,1932,True,307,118,sebsi:1  marzouki:1  
4,1,6,15,4,454,273,500,1,226,273,500,0,0,259,7,7,273,0,1815,1915,True,148,111,sebsi:1  marzouki:1  
4,1,6,15,3,456,333,503,1,169,333,503,0,0,324,7,2,333,0,1820,1909,True,195,129,sebsi:1  marzouki:1  
4,1,6,15,2,456,342,500,1,157,342,500,0,0,335,4,3,342,0,1815,1910,True,220,115,sebsi:1  marzouki:1  
4,1,6,15,1,456,350,500,1,149,350,500,0,0,340,3,7,350,0,1815,1921,False,244,96,sebsi:1  marzouki:1  
4,1,6,14,4,531,367,600,0,234,366,600,0,1,359,4,3,366,0,,1925,True,205,154,sebsi:1  marzouki:1  
4,1,6,14,3,531,380,600,0,220,380,600,0,0,365,12,3,380,0,1800,1940,False,214,151,sebsi:1  marzouki:1  
4,1,6,14,2,531,390,600,1,210,389,600,0,1,382,4,3,389,0,1800,1930,False,220,162,sebsi:1  marzouki:1  
4,1,6,14,1,531,414,600,1,185,414,600,0,0,403,7,4,414,0,1831,1951,True,282,121,sebsi:1  marzouki:1  
4,1,5,13,7,593,373,700,3,324,373,700,0,0,358,8,7,373,0,1830,1946,False,300,58,sebsi:1  marzouki:1  
4,1,5,13,6,597,400,700,0,300,400,700,0,0,388,6,6,400,0,1825,2000,True,325,63,sebsi:1  marzouki:1  
4,1,5,13,5,597,416,700,0,283,417,700,0,1,405,9,3,417,0,,1938,False,359,46,sebsi:1  marzouki:1  
4,1,5,13,4,597,448,700,2,250,448,700,0,0,442,3,3,448,0,1812,1930,False,363,79,sebsi:1  marzouki:1  
4,1,5,13,3,597,447,700,0,253,447,700,0,0,440,7,0,447,0,1815,1948,True,370,70,sebsi:1  marzouki:1  
4,1,5,13,2,597,482,700,0,218,482,700,0,0,474,6,2,482,0,1825,1930,True,417,57,sebsi:1  marzouki:1  
4,1,5,13,1,597,489,700,3,208,489,700,0,0,473,10,6,489,0,1820,2000,False,405,68,sebsi:1  marzouki:1  
4,1,5,12,8,544,407,595,0,188,407,595,0,0,394,7,6,407,0,1815,2110,False,352,42,sebsi:1  marzouki:1  
4,1,5,12,7,551,429,600,0,171,429,600,0,0,413,10,6,429,0,1820,1930,True,366,47,sebsi:1  marzouki:1  
4,1,5,12,6,551,447,600,0,153,447,600,0,0,438,3,6,447,0,,1858,False,382,56,sebsi:1  marzouki:1  
4,1,5,12,5,551,492,600,1,107,492,600,0,0,489,2,1,492,0,1815,1920,False,410,79,sebsi:1  marzouki:1  
4,1,5,12,4,551,456,609,0,153,456,609,0,0,446,3,7,456,0,,1947,False,359,87,sebsi:1  marzouki:1  
4,1,5,12,3,551,491,600,3,106,491,600,0,0,484,5,2,491,0,1815,1935,True,433,51,sebsi:1  :1  
4,1,5,12,2,551,491,600,0,109,491,600,0,0,482,4,5,491,0,1815,2020,True,436,46,sebsi:1  :1  
4,1,5,12,1,551,493,600,1,106,493,600,0,0,482,8,3,493,0,1815,2000,True,443,39,sebsi:1  marzouki:1  
4,1,4,11,4,587,429,700,1,270,429,700,0,0,421,5,3,429,0,1815,1910,False,348,73,sebsi:1  marzouki:1  
4,1,4,11,2,587,466,700,0,234,466,700,0,0,458,5,3,466,0,1830,1937,True,377,81,sebsi:1  marzouki:1  
4,1,4,11,1,587,500,700,1,199,500,700,0,0,496,3,1,500,0,1805,,False,435,61,sebsi:1  marzouki:1  
4,1,4,10,7,559,431,600,0,169,431,600,0,0,415,5,11,431,0,1850,2000,False,355,60,sebsi:1  marzouki:1  
4,1,4,10,6,565,455,600,0,145,455,600,0,0,446,4,5,455,0,1845,1945,False,386,60,sebsi:1  marzouki:1  
4,1,4,10,5,565,487,496,4,105,487,596,0,0,476,6,5,487,0,1845,2011,False,395,81,sebsi:1  marzouki:1  
4,1,4,10,4,565,496,597,1,100,496,597,0,0,493,1,2,496,0,1820,1940,False,416,77,sebsi:1  marzouki:1  
4,1,4,10,2,565,499,600,0,101,499,600,0,0,490,8,1,499,0,1852,2000,True,436,54,sebsi:1  marzouki:1  
4,1,4,10,1,565,497,600,2,101,497,600,0,0,485,6,6,497,0,1850,1955,False,421,64,sebsi:1  marzouki:0  
4,1,3,9,9,534,299,600,0,301,299,600,0,0,285,11,3,299,0,1815,1910,True,167,118,sebsi:1  marzouki:1  
4,1,3,9,8,534,344,600,0,256,344,600,0,0,340,3,1,344,0,1815,1855,True,215,125,sebsi:1  marzouki:1  
4,1,3,9,7,534,347,596,0,249,347,596,0,0,325,10,12,347,0,1819,1917,True,224,101,sebsi:1  marzouki:1  
4,1,3,9,6,534,368,600,0,232,368,600,0,0,361,4,3,368,0,1815,1925,True,233,128,sebsi:1  marzouki:1  
4,1,3,9,5,534,402,600,0,198,402,600,0,0,392,6,4,402,0,1815,1905,True,226,166,sebsi:1  marzouki:1  
4,1,3,9,4,534,387,600,0,213,387,600,0,0,377,7,3,387,0,1820,1930,True,241,136,sebsi:1  marzouki:1  
4,1,3,9,3,534,438,598,1,159,438,598,0,0,428,7,3,438,0,1815,1915,False,324,104,sebsi:1  marzouki:1  
4,1,3,9,2,534,442,596,1,153,442,596,0,0,431,8,3,442,0,1820,1935,True,339,92,sebsi:1  marzouki:1  
4,1,3,9,1,534,441,600,0,159,441,600,0,0,432,3,6,441,0,1825,1945,True,345,87,sebsi:1  marzouki:1  
4,1,3,8,5,496,276,600,1,323,276,600,0,0,268,4,4,276,0,1829,1912,True,138,130,sebsi:1  marzouki:1  
4,1,3,8,4,499,302,600,1,297,302,600,0,0,296,6,0,302,0,1820,1900,True,163,133,sebsi:1  marzouki:1  
4,1,3,8,3,499,318,600,0,282,318,600,0,0,309,7,2,318,0,1824,1905,True,190,119,sebsi:1  marzouki:1  
4,1,3,8,2,499,344,597,0,253,344,597,0,0,337,4,3,344,0,1817,1925,True,217,120,sebsi:1  marzouki:1  
4,1,3,8,1,499,395,600,0,205,395,600,0,0,392,2,1,395,0,1820,1925,True,295,97,sebsi:1  marzouki:1  
4,1,3,7,7,582,335,700,0,365,335,700,0,0,325,7,3,335,0,1810,1915,True,175,150,sebsi:1  marzouki:1  
4,1,3,7,6,585,360,708,1,347,360,708,0,0,349,7,4,360,0,1800,1920,True,217,132,sebsi:1  marzouki:1  
4,1,3,7,5,585,394,700,2,304,394,700,0,0,381,4,9,394,0,1815,,False,233,148,sebsi:1  marzouki:1  
4,1,3,7,4,585,411,700,0,290,410,700,0,1,401,7,2,410,0,1815,1920,False,200,201,sebsi:1  marzouki:1  
4,1,3,7,3,585,438,703,2,263,438,703,0,0,423,11,4,438,0,1815,1915,False,288,135,sebsi:1  marzouki:1  
4,1,3,7,2,585,460,700,2,238,460,700,0,0,452,8,0,460,0,1805,1938,True,330,122,sebsi:1  marzouki:1  
4,1,2,5,1,444,293,500,0,207,293,500,0,0,277,8,8,293,0,1815,1915,True,199,78,sebsi:1  marzouki:0  
4,1,2,4,7,523,350,600,0,250,350,600,0,0,346,2,2,350,0,1825,1930,True,244,102,sebsi:1  marzouki:1  
4,1,2,4,6,523,358,600,0,242,358,600,0,0,344,8,6,358,0,1800,1935,True,242,102,sebsi:1  marzouki:1  
4,1,2,4,5,523,363,600,1,236,363,600,0,0,353,6,4,363,0,1820,1925,True,224,129,sebsi:1  marzouki:1  
4,1,2,4,4,523,395,600,2,203,395,600,0,0,382,6,7,395,0,1820,1937,True,263,119,sebsi:1  marzouki:1  
4,1,2,4,3,523,403,600,0,197,403,600,0,0,392,3,8,403,0,1808,1909,True,283,109,sebsi:1  marzouki:1  
4,1,2,4,2,523,422,600,6,172,422,600,0,0,409,9,4,422,0,1830,1942,False,337,72,sebsi:1  marzouki:1  
4,1,2,4,1,523,428,600,0,172,428,600,0,0,411,12,5,428,0,1815,1940,True,328,83,sebsi:1  marzouki:1  
4,1,2,3,6,509,308,600,0,292,308,600,0,0,302,5,1,308,0,1820,,True,173,129,sebsi:1  marzouki:0  
4,1,2,3,5,513,302,600,0,298,302,600,0,0,293,7,2,302,0,1830,1920,False,198,95,sebsi:1  marzouki:1  
4,1,2,3,4,513,351,600,0,249,351,600,0,0,343,5,3,351,0,1830,1915,True,200,143,sebsi:1  marzouki:1  
4,1,2,3,3,513,382,600,0,218,382,600,0,0,374,5,3,382,0,1815,1905,True,256,118,sebsi:1  marzouki:1  
4,1,2,3,2,513,377,600,2,221,377,600,0,0,369,6,2,377,0,,1914,True,273,96,sebsi:1  marzouki:1  
4,1,2,3,1,513,408,600,1,191,408,600,0,0,398,6,4,408,0,1835,1937,True,305,93,sebsi:1  marzouki:1  
4,1,2,2,8,582,431,700,0,269,431,700,0,0,421,5,5,431,0,1812,1935,True,320,101,sebsi:1  marzouki:1  
4,1,2,2,7,588,431,700,0,269,431,700,0,0,414,9,8,431,0,1807,1900,False,316,98,sebsi:1  marzouki:1  
4,1,2,2,6,588,456,700,0,244,456,700,0,0,449,5,2,456,0,1815,1915,False,337,112,sebsi:1  marzouki:1  
4,1,2,2,5,588,475,700,0,225,475,700,0,0,469,4,2,475,0,1815,1925,False,317,152,sebsi:1  marzouki:1  
4,1,2,2,4,588,478,700,1,221,478,700,0,0,470,2,6,478,0,1820,1920,False,337,133,sebsi:  marzouki:  
4,1,2,2,3,588,488,700,0,212,488,700,0,0,478,4,6,488,0,1810,1900,False,346,132,sebsi:1  marzouki:1  
4,1,1,1,7,546,334,600,1,265,334,600,0,0,323,5,6,334,0,1830,1935,True,206,117,sebsi:1  marzouki:1  
4,1,1,1,6,550,370,600,1,229,370,600,0,0,358,8,4,370,0,1830,1930,False,227,131,sebsi:1  marzouki:1  
4,1,1,1,5,550,386,600,0,214,386,600,0,0,379,4,3,386,0,1835,1937,True,242,137,sebsi:1  marzouki:1  
4,1,1,1,4,550,443,600,0,157,443,600,0,0,434,6,3,443,0,1810,1910,True,276,158,sebsi:1  marzouki:1  
4,1,1,1,3,550,447,600,0,153,447,600,0,0,437,8,2,447,0,,1930,False,322,115,sebsi:1  marzouki:1  
4,1,1,1,2,550,461,600,1,138,461,600,0,0,454,3,4,461,0,1810,1915,False,346,108,sebsi:1  marzouki:1  
4,1,1,1,1,550,468,600,0,132,468,600,0,0,460,5,3,468,0,1815,1915,True,357,103,sebsi:1  marzouki:1  
