circonscriptionId,delegationId,subDelegationId,centerID,stationId,registeredVoters,aSigningVoters,bDeliveredBallots,cSpoiledBallots,dLeftBallots,fExtractedBallots,gEplusF,hBminusG,iAminusF,jListVotes,kCancelledVotes,lBlankVotes,mJplusKplusL,nFminusM,countingStart,countingEnd,tampon,sebsi,marzouki,observers
8,7,9,120,1,214,66,300,0,234,66,300,0,0,63,1,2,66,0,1815,1835,True,35,28,sebsi:1  marzouki:1  
8,7,9,118,2,385,174,500,0,326,174,500,0,0,172,2,0,174,0,1815,1830,True,70,102,sebsi:2  marzouki:1  
8,7,9,118,1,386,251,500,1,248,251,500,0,0,239,11,1,251,0,1830,2000,True,143,96,sebsi:0  marzouki:1  
8,7,9,117,2,349,123,400,0,277,123,400,0,0,120,3,0,123,0,1810,1835,True,40,80,sebsi:1  marzouki:0  
8,7,9,117,1,349,162,400,0,238,162,400,0,0,153,8,1,162,0,1805,1900,True,73,80,sebsi:1  marzouki:1  
8,7,8,116,1,416,125,500,0,375,125,500,0,0,117,1,7,125,0,1805,1850,True,85,32,sebsi:1  marzouki:1  
8,7,8,115,1,504,181,600,1,418,181,600,0,0,172,4,5,181,0,1805,1900,True,130,42,sebsi:1  marzouki:1  
8,7,7,114,2,447,215,500,0,285,215,500,0,0,211,4,0,215,0,1800,1840,True,160,51,sebsi:1  marzouki:1  
8,7,7,113,1,136,46,200,0,154,46,200,0,0,45,1,0,46,0,1800,1830,True,36,9,sebsi:1  marzouki:1  
8,7,6,112,1,244,152,300,0,148,152,300,0,0,150,1,1,152,0,1810,1830,True,94,56,sebsi:1  marzouki:1  
8,7,6,111,1,233,144,300,1,155,144,300,0,0,141,1,2,144,0,1815,1845,True,49,92,sebsi:1  marzouki:1  
8,7,5,110,1,289,130,382,0,252,130,382,0,0,126,3,1,130,0,1815,1830,True,100,26,sebsi:1  marzouki:0  
8,7,5,109,1,157,70,200,0,130,70,200,0,0,68,2,0,70,0,1800,1830,True,40,28,sebsi:1  marzouki:1  
8,7,5,108,1,262,134,300,0,166,134,300,0,0,134,0,0,134,0,1815,1820,True,96,38,sebsi:1  marzouki:1  
8,7,4,107,1,306,149,400,0,251,149,400,0,0,143,6,0,149,0,1800,1900,True,82,61,sebsi:1  marzouki:0  
8,7,4,106,2,467,119,500,0,381,119,500,0,0,115,3,1,119,0,1800,1841,True,60,55,sebsi:0  marzouki:1  
8,7,4,106,1,468,244,496,2,250,244,496,0,0,228,14,2,244,0,1800,1900,True,179,49,sebsi:1  marzouki:1  
8,7,4,105,1,321,164,400,0,236,164,400,0,0,159,3,2,164,0,1820,1855,True,92,67,sebsi:1  marzouki:1  
8,7,4,104,2,386,144,500,0,356,144,500,0,0,138,3,3,144,0,1800,1910,True,66,72,sebsi:1  marzouki:1  
8,7,4,104,1,386,208,500,0,292,208,500,0,0,204,4,0,208,0,1805,1845,True,122,82,sebsi:1  marzouki:1  
8,7,3,103,1,147,37,200,0,163,37,200,0,0,34,3,0,37,0,1810,1820,True,25,9,sebsi:1  marzouki:0  
8,7,3,102,1,168,46,200,0,154,46,200,0,0,42,4,0,46,0,1820,1900,True,23,19,sebsi:1  marzouki:1  
8,7,3,101,1,161,37,200,1,162,37,200,0,0,34,3,0,37,0,1800,1820,True,30,4,sebsi:1  marzouki:0  
8,7,3,100,1,301,99,400,0,301,99,400,0,0,98,1,0,99,0,1805,,True,83,15,sebsi:1  marzouki:1  
8,7,2,99,1,190,82,200,0,118,82,200,0,0,80,0,2,82,0,1800,1835,True,63,17,sebsi:1  marzouki:1  
8,7,2,98,1,214,68,300,0,232,68,300,0,0,66,1,1,68,0,1810,1820,True,37,29,sebsi:1  marzouki:0  
8,7,1,97,2,548,343,600,0,257,343,600,0,0,326,10,7,343,0,1815,1900,True,190,136,sebsi:1  marzouki:1  
8,7,1,97,1,549,435,596,0,161,435,596,0,0,423,7,5,435,0,1815,1909,True,258,165,sebsi:1  marzouki:1  
8,7,1,96,7,513,266,595,0,329,266,595,0,0,254,12,0,266,0,1810,1913,True,158,96,sebsi:1  marzouki:0  
8,7,1,96,6,516,264,600,0,336,264,600,0,0,259,4,1,264,0,1805,1853,True,147,112,sebsi:1  marzouki:1  
8,7,1,96,5,516,304,600,0,296,304,600,0,0,297,4,3,304,0,1800,1900,True,190,107,sebsi:1  marzouki:1  
8,7,1,96,4,516,359,600,0,241,359,600,0,0,351,6,2,359,0,1815,1905,True,237,114,sebsi:1  marzouki:0  
8,7,1,96,3,516,416,600,0,184,416,600,0,0,413,3,0,416,0,1805,1855,True,294,119,sebsi:1  marzouki:1  
8,7,1,96,2,516,374,600,0,228,373,601,1,1,360,5,8,373,0,1800,1915,True,280,80,sebsi:1  marzouki:1  
8,7,1,96,1,516,429,600,2,169,429,600,0,0,413,8,8,429,0,1805,2010,True,333,80,sebsi:1  marzouki:1  
8,8,8,142,1,312,119,400,1,280,119,400,0,0,117,1,1,119,0,1810,1900,True,79,38,sebsi:1  marzouki:0  
8,8,7,141,1,170,75,200,1,124,75,200,0,0,72,0,3,75,0,1805,1835,True,63,9,sebsi:1  marzouki:0  
8,8,7,140,1,174,102,200,0,98,102,200,0,0,98,3,1,102,0,1800,1845,True,81,17,sebsi:1  marzouki:0  
8,8,6,139,1,153,68,200,0,132,68,200,0,0,68,0,0,68,0,1800,1815,True,35,33,sebsi:1  marzouki:0  
8,8,6,138,1,326,111,400,0,289,111,400,0,0,109,2,0,111,0,1812,1838,True,84,25,sebsi:1  marzouki:0  
8,8,6,137,1,309,119,400,0,281,119,400,0,0,112,7,0,119,0,1800,1900,True,92,20,sebsi:0  marzouki:0  
8,8,5,136,1,375,181,400,1,218,181,400,0,0,169,0,12,181,0,1800,2000,True,129,40,sebsi:1  marzouki:1  
8,8,5,135,1,162,55,200,0,145,55,200,0,0,55,0,0,55,0,1800,1830,True,45,10,sebsi:1  marzouki:0  
8,8,4,134,1,201,98,300,0,202,98,300,0,0,96,2,0,98,0,1815,1835,True,78,18,sebsi:1  marzouki:1  
8,8,4,133,1,114,50,200,0,150,50,200,0,0,49,0,1,50,0,1800,1900,True,38,11,sebsi:1  marzouki:1  
8,8,4,132,1,392,153,500,0,347,153,500,0,0,146,6,1,153,0,1803,1827,True,119,27,sebsi:1  marzouki:1  
8,8,3,131,1,207,79,300,0,221,79,300,0,0,77,2,0,79,0,1805,1828,True,56,21,sebsi:1  marzouki:1  
8,8,3,130,1,211,83,300,0,217,83,300,0,0,83,0,0,83,0,1800,1845,True,76,7,sebsi:0  marzouki:0  
8,8,3,129,1,432,204,500,0,296,204,500,0,0,196,2,6,204,0,1805,1850,True,157,39,sebsi:1  marzouki:1  
8,8,2,127,3,564,291,600,0,309,291,600,0,0,285,4,2,291,0,1820,1910,True,173,112,sebsi:1  marzouki:1  
8,8,2,127,2,566,396,600,1,203,396,600,0,0,391,2,3,396,0,1800,1911,True,285,106,sebsi:1  marzouki:1  
8,8,2,127,1,566,418,600,0,182,418,600,0,0,408,9,1,418,0,1800,1935,True,317,91,sebsi:1  marzouki:1  
8,8,2,126,2,434,220,500,0,280,220,500,0,0,215,5,0,220,0,1810,1900,True,156,59,sebsi:1  marzouki:0  
8,8,2,126,1,434,314,496,5,177,314,496,0,0,304,6,4,314,0,1810,1910,True,254,50,sebsi:1  marzouki:0  
8,8,1,124,4,490,225,598,0,373,225,598,0,0,218,3,4,225,0,1815,1900,True,144,74,sebsi:1  marzouki:1  
8,8,1,124,3,492,276,600,0,324,276,600,0,0,266,4,6,276,0,1810,1856,True,190,76,sebsi:1  marzouki:1  
8,8,1,124,2,492,367,596,1,228,367,593,0,0,357,9,1,367,0,1810,1925,True,288,69,sebsi:1  marzouki:1  
8,8,1,124,1,492,367,600,2,231,367,600,0,0,364,3,0,367,0,1800,1910,True,314,50,sebsi:1  marzouki:1  
8,8,1,123,3,554,291,600,2,307,291,600,0,0,281,8,2,291,0,1815,1905,True,181,100,sebsi:1  marzouki:1  
8,8,1,123,2,554,371,600,0,229,371,600,0,0,361,8,2,371,0,1800,1900,True,265,96,sebsi:1  marzouki:1  
8,8,1,123,1,554,419,600,1,180,419,600,0,0,409,5,5,419,0,1815,1931,True,328,81,sebsi:1  marzouki:1  
8,8,1,122,2,356,192,399,0,207,192,399,0,0,190,0,2,192,0,1800,1830,True,124,66,sebsi:1  marzouki:1  
8,8,1,122,1,356,270,400,1,129,270,400,0,0,263,4,3,270,0,1800,1915,True,192,71,sebsi:1  marzouki:1  
8,8,1,121,3,469,229,500,0,271,229,500,0,0,218,7,4,229,0,1810,1850,True,148,70,sebsi:1  marzouki:1  
8,8,1,121,2,470,323,500,0,177,323,500,0,0,321,2,0,323,0,1815,1845,True,228,93,sebsi:1  marzouki:1  
8,8,1,121,1,470,366,500,1,133,366,500,0,0,347,14,5,366,0,1810,1945,True,276,71,sebsi:1  marzouki:1  
8,5,6,82,1,61,28,100,0,72,28,100,0,0,28,0,0,28,0,1805,1823,True,26,2,sebsi:1  marzouki:0  
8,5,6,81,1,485,293,600,0,307,293,600,0,0,277,13,3,293,0,1800,1850,True,243,34,sebsi:1  marzouki:1  
8,5,5,80,1,234,116,300,0,184,116,300,0,0,108,8,0,116,0,1800,1825,True,86,22,sebsi:1  marzouki:1  
8,5,5,79,1,520,256,600,1,343,256,600,0,0,243,4,9,256,0,1810,1900,True,176,67,sebsi:1  marzouki:1  
8,5,5,78,1,360,129,397,0,268,129,397,0,0,126,3,0,129,0,1805,1905,True,105,21,sebsi:1  marzouki:1  
8,5,4,77,1,589,183,700,0,517,183,700,0,0,180,2,1,183,0,1800,1840,True,155,25,sebsi:1  marzouki:1  
8,5,3,76,1,302,134,400,0,266,134,400,0,0,131,1,2,134,0,1810,1835,True,93,38,sebsi:1  marzouki:1  
8,5,2,75,1,400,238,496,0,258,238,496,0,0,231,0,7,238,0,1800,,True,150,81,sebsi:1  marzouki:1  
8,5,2,74,1,293,141,400,0,259,141,400,0,0,136,3,2,141,0,1805,1910,True,96,40,sebsi:2  marzouki:1  
8,5,1,73,1,588,316,700,0,384,316,700,0,0,296,16,4,316,0,1810,1919,True,204,92,sebsi:1  marzouki:1  
8,5,1,72,4,547,241,600,0,359,241,600,0,0,230,6,5,241,0,1807,1907,True,115,115,sebsi:1  marzouki:1  
8,5,1,72,3,550,316,600,0,284,316,600,0,0,303,9,4,316,0,1800,1935,True,154,149,sebsi:1  marzouki:1  
8,5,1,72,2,550,360,600,0,240,360,600,0,0,353,3,4,360,0,1820,1905,True,199,154,sebsi:1  marzouki:1  
8,5,1,72,1,550,360,600,1,239,360,600,0,0,344,14,1,359,1,1800,2000,True,216,128,sebsi:1  marzouki:1  
8,1,10,28,1,249,51,300,1,248,51,300,0,0,49,2,0,51,0,1810,1830,True,32,17,sebsi:0  marzouki:0  
8,1,10,27,1,304,131,400,0,269,131,400,0,0,129,2,0,131,0,1800,1835,True,104,25,sebsi:1  marzouki:0  
8,1,10,26,1,424,121,500,0,379,121,500,0,0,112,9,0,121,0,1800,1900,True,91,21,sebsi:1  marzouki:0  
8,1,9,25,1,372,142,402,0,260,142,402,0,0,136,2,4,142,0,1810,1830,False,92,44,sebsi:1  marzouki:0  
8,1,8,24,1,505,239,600,0,361,239,600,0,0,237,2,0,239,0,1810,1900,True,175,62,sebsi:1  marzouki:1  
8,1,8,23,1,229,105,300,0,195,105,300,0,0,99,3,3,105,0,1800,1835,True,84,15,sebsi:1  marzouki:1  
8,1,8,22,2,323,112,400,0,288,112,400,0,0,109,2,1,112,0,1833,1900,True,63,46,sebsi:1  marzouki:0  
8,1,8,22,1,324,198,400,1,201,198,400,0,0,192,5,1,198,0,1805,1900,True,137,55,sebsi:1  marzouki:1  
8,1,8,21,1,439,143,500,3,354,143,500,0,0,140,1,2,143,0,1825,1840,True,93,47,sebsi:0  marzouki:0  
8,1,8,20,4,498,141,600,1,458,141,600,0,0,137,4,0,141,0,1809,1851,True,90,47,sebsi:1  marzouki:0  
8,1,8,20,3,498,204,600,0,396,204,600,0,0,198,2,4,204,0,1800,1855,True,139,59,sebsi:1  marzouki:1  
8,1,8,20,2,498,328,600,0,272,328,600,0,0,306,22,0,328,0,1805,1918,True,221,85,sebsi:1  marzouki:1  
8,1,8,20,1,498,319,600,0,281,319,600,0,0,309,8,2,319,0,1830,2050,True,250,59,sebsi:1  marzouki:1  
8,1,7,19,1,165,71,200,0,129,71,200,0,0,66,4,1,71,0,1805,1900,True,59,7,sebsi:1  marzouki:0  
8,1,7,18,1,389,127,500,0,373,127,500,0,0,121,5,1,127,0,1810,1840,True,99,22,sebsi:1  marzouki:0  
8,1,6,17,1,320,150,400,0,250,150,400,0,0,145,4,1,150,0,1805,1840,True,94,51,sebsi:1  marzouki:0  
8,1,5,16,1,108,27,200,0,173,27,200,0,0,27,0,0,27,0,1800,1825,True,26,1,sebsi:1  marzouki:0  
8,1,5,15,1,132,45,200,0,155,45,200,0,0,38,7,0,45,0,1802,1845,True,35,3,sebsi:0  marzouki:0  
8,1,4,14,1,187,67,199,0,132,67,199,0,0,62,4,1,67,0,1813,1835,True,42,20,sebsi:0  marzouki:0  
8,1,4,13,1,304,143,400,0,257,143,400,0,0,140,2,1,143,0,1805,1850,True,123,17,sebsi:1  marzouki:0  
8,1,4,12,1,164,51,200,0,149,51,200,0,0,47,4,0,51,0,1800,1900,True,35,12,sebsi:1  marzouki:0  
8,1,3,11,1,119,38,200,0,162,38,200,0,0,38,0,0,38,0,1810,1831,True,34,4,sebsi:1  marzouki:0  
8,1,3,10,1,92,68,100,0,32,68,100,0,0,68,0,0,68,0,1800,1815,True,59,9,sebsi:1  marzouki:0  
8,1,3,9,1,126,37,200,0,163,37,200,0,0,34,1,2,37,0,1830,2030,True,24,10,sebsi:1  marzouki:0  
8,1,3,8,1,71,28,100,0,72,28,100,0,0,28,0,0,28,0,1800,1820,True,26,2,sebsi:1  marzouki:0  
8,1,3,7,1,217,97,300,0,203,97,300,0,0,92,5,0,97,0,1805,1900,True,80,12,sebsi:1  marzouki:1  
8,1,2,6,1,50,19,102,0,83,19,102,0,0,18,1,0,19,0,1820,1835,True,17,1,sebsi:0  marzouki:0  
8,1,2,5,1,397,126,500,0,374,126,500,0,0,120,4,2,126,0,1805,1850,True,108,12,sebsi:1  marzouki:0  
8,1,2,4,1,462,111,500,0,389,111,500,0,0,110,0,1,111,0,1810,,True,76,34,sebsi:1  marzouki:0  
8,1,1,3,1,130,22,200,0,178,22,200,0,0,22,0,0,22,0,1830,1900,True,19,3,sebsi:0  marzouki:0  
8,1,1,2,1,369,105,400,0,295,105,400,0,0,98,6,1,105,0,1800,1900,False,81,17,sebsi:1  marzouki:0  
8,1,1,1,1,269,59,300,0,241,59,300,0,0,59,0,0,59,0,1800,1835,True,33,26,sebsi:1  marzouki:0  
8,11,10,192,1,189,89,200,0,111,89,200,0,0,88,0,1,89,0,,1830,True,30,58,sebsi:1  marzouki:1  
8,11,10,191,1,235,102,300,0,198,102,300,0,0,97,2,3,102,0,1810,1830,True,52,45,sebsi:1  marzouki:1  
8,11,10,190,1,110,36,200,0,164,36,200,0,0,36,0,0,36,0,1810,,True,12,24,sebsi:1  marzouki:0  
8,11,10,189,1,249,119,300,0,181,119,300,0,0,112,7,0,119,0,1805,1844,True,74,38,sebsi:1  marzouki:0  
8,11,9,188,1,141,68,200,0,132,68,200,0,0,68,0,0,68,0,1800,1823,True,51,17,sebsi:1  marzouki:1  
8,11,9,187,1,539,242,600,0,358,242,600,0,0,228,13,1,242,0,1800,1845,True,175,53,sebsi:1  marzouki:0  
8,11,8,186,1,306,133,400,0,267,133,400,0,0,129,0,4,133,0,1800,1830,True,96,33,sebsi:1  marzouki:0  
8,11,7,185,1,120,29,200,0,171,29,200,0,0,27,2,0,29,0,1815,1845,True,21,6,sebsi:0  marzouki:0  
8,11,7,184,1,429,164,500,0,336,164,500,0,0,155,9,0,164,0,1805,1850,True,102,53,sebsi:1  marzouki:0  
8,11,6,183,1,137,67,200,0,133,67,200,0,0,64,1,2,67,0,1800,1840,True,59,5,sebsi:1  marzouki:0  
8,11,6,182,1,372,135,400,1,264,135,400,0,0,133,2,0,135,0,1810,1840,True,57,76,sebsi:1  marzouki:1  
8,11,5,181,1,206,103,300,0,197,103,300,0,0,102,1,0,103,0,1810,1900,True,64,38,sebsi:1  marzouki:1  
8,11,5,180,1,359,157,399,0,242,157,399,0,0,151,6,0,157,0,1800,1830,True,68,83,sebsi:  marzouki:  
8,11,4,178,1,282,123,300,1,176,123,300,0,0,111,2,10,123,0,1815,1835,True,78,33,sebsi:1  marzouki:0  
8,11,4,177,1,108,37,200,0,163,37,200,0,0,35,2,0,37,0,1800,1825,True,28,7,sebsi:1  marzouki:0  
8,11,3,176,1,159,69,200,0,131,69,200,0,0,66,2,1,69,0,1800,1840,True,29,37,sebsi:1  marzouki:0  
8,11,3,175,1,287,147,400,0,253,147,400,0,0,142,4,1,147,0,1800,1840,True,117,25,sebsi:1  marzouki:0  
8,11,2,174,2,434,164,500,0,336,164,500,0,0,154,9,1,164,0,1815,1840,True,77,77,sebsi:1  marzouki:1  
8,11,2,174,1,435,259,500,1,241,258,500,0,1,249,6,3,258,0,1810,1900,True,151,98,sebsi:1  marzouki:1  
8,11,1,173,2,419,181,500,0,319,181,500,0,0,179,0,2,181,0,1800,1837,True,99,80,sebsi:1  marzouki:0  
8,11,1,173,1,419,267,500,0,233,267,500,0,0,259,8,0,267,0,1805,1845,True,186,73,sebsi:1  marzouki:0  
8,11,1,172,3,474,181,500,0,319,181,500,0,0,174,6,1,181,0,1815,1855,True,88,86,sebsi:1  marzouki:1  
8,11,1,172,2,476,278,500,0,222,278,500,0,0,273,3,2,278,0,1800,1845,True,141,132,sebsi:1  marzouki:1  
8,11,1,172,1,476,326,500,0,174,326,500,0,0,316,5,5,326,0,1830,1930,True,223,93,sebsi:1  marzouki:1  
8,11,1,171,5,492,252,600,2,346,252,600,0,0,240,11,1,252,0,1810,1900,True,116,124,sebsi:1  marzouki:0  
8,11,1,171,4,493,264,600,0,336,264,600,0,0,257,4,3,264,0,1810,1900,True,121,136,sebsi:1  marzouki:1  
8,11,1,171,3,493,349,600,0,251,349,600,0,0,341,7,1,349,0,1800,1920,True,195,146,sebsi:1  marzouki:1  
8,11,1,171,2,493,348,600,0,252,348,600,0,0,339,3,6,348,0,1815,1915,True,218,121,sebsi:1  marzouki:1  
8,11,1,171,1,493,349,600,1,250,349,600,0,0,342,2,5,349,0,1810,1844,True,245,97,sebsi:1  marzouki:1  
8,11,1,170,3,480,199,600,0,401,199,600,0,0,195,3,1,199,0,1810,1840,True,93,102,sebsi:1  marzouki:1  
8,11,1,170,2,482,309,600,0,291,309,600,0,0,300,3,6,309,0,1810,1849,True,178,122,sebsi:1  marzouki:1  
8,11,1,170,1,482,304,600,2,294,304,600,0,0,296,6,2,304,0,1810,1901,True,217,79,sebsi:1  marzouki:1  
8,3,7,55,1,399,238,496,0,258,238,496,0,0,231,5,2,238,0,1815,1855,True,196,35,sebsi:1  marzouki:1  
8,3,7,54,1,142,77,200,0,123,77,200,0,0,71,4,2,77,0,1815,1845,True,52,19,sebsi:1  marzouki:1  
8,3,7,53,1,200,116,300,0,184,116,300,0,0,115,0,1,116,0,1815,1835,True,96,19,sebsi:1  marzouki:1  
8,3,6,52,1,329,215,400,1,184,215,400,0,0,209,2,4,215,0,1800,1850,True,178,31,sebsi:1  marzouki:0  
8,3,6,51,1,151,83,200,0,117,83,200,0,0,80,1,2,83,0,,1900,True,71,9,sebsi:1  marzouki:0  
8,3,6,50,2,340,174,400,0,226,174,400,0,0,166,5,3,174,0,1813,1842,True,112,54,sebsi:1  marzouki:1  
8,3,6,50,1,341,242,400,0,158,242,400,0,0,232,3,7,242,0,1800,1853,True,197,35,sebsi:1  marzouki:1  
8,3,5,49,1,49,19,100,0,81,19,100,0,0,17,1,1,19,0,1800,1830,True,17,0,sebsi:1  marzouki:0  
8,3,5,48,1,163,72,200,0,128,72,200,0,0,71,1,0,72,0,1800,1845,True,66,5,sebsi:1  marzouki:0  
8,3,5,47,1,88,48,100,0,52,48,100,0,0,47,1,0,48,0,1800,1829,True,46,1,sebsi:1  marzouki:0  
8,3,5,46,1,260,163,300,0,137,163,300,0,0,162,0,1,163,0,1800,1828,True,152,10,sebsi:1  marzouki:1  
8,3,4,45,2,368,105,400,1,294,105,400,0,0,102,2,1,105,0,1815,1845,True,73,29,sebsi:1  marzouki:0  
8,3,4,45,1,369,180,400,0,220,180,400,0,0,171,7,2,180,0,1810,1839,True,126,45,sebsi:1  marzouki:0  
8,3,3,44,1,231,104,300,0,196,104,300,0,0,98,6,0,104,0,1815,1840,True,82,16,sebsi:1  marzouki:0  
8,3,3,43,1,79,41,100,0,59,41,100,0,0,41,0,0,41,0,1810,1835,True,35,6,sebsi:1  marzouki:0  
8,3,3,42,2,313,153,400,1,246,153,400,0,0,151,2,0,153,0,1820,1900,True,119,32,sebsi:1  marzouki:0  
8,3,3,42,1,314,219,400,1,180,219,400,0,0,211,5,3,219,0,1807,1848,True,182,29,sebsi:1  marzouki:0  
8,3,2,41,2,513,260,600,0,340,260,600,0,0,258,0,2,260,0,1800,1830,True,161,97,sebsi:1  marzouki:0  
8,3,2,41,1,513,368,600,0,232,368,600,0,0,360,4,4,368,0,1815,1857,True,286,74,sebsi:1  marzouki:1  
8,3,1,40,1,122,74,200,0,126,74,200,0,0,72,1,1,74,0,1805,1830,True,70,2,sebsi:1  marzouki:0  
8,3,1,39,4,461,202,500,1,298,201,500,0,1,200,1,0,201,0,1810,1855,True,131,69,sebsi:1  marzouki:0  
8,3,1,39,3,462,277,500,0,223,277,500,0,0,265,6,6,277,0,1810,1900,True,184,81,sebsi:1  marzouki:0  
8,3,1,39,2,462,326,500,2,172,326,500,0,0,311,11,4,326,0,1800,1915,True,240,71,sebsi:1  marzouki:0  
8,3,1,39,1,462,336,500,1,163,336,500,0,0,329,3,4,336,0,1805,1858,True,252,77,sebsi:1  marzouki:0  
8,3,1,38,3,559,262,600,0,338,262,600,0,0,252,6,4,262,0,1806,1847,True,154,98,sebsi:1  marzouki:0  
8,3,1,38,2,560,361,600,1,238,361,600,0,0,353,5,3,361,0,1810,1910,True,249,104,sebsi:1  marzouki:0  
8,3,1,38,1,560,374,600,0,226,374,600,0,0,348,26,0,374,0,1820,1909,True,266,82,sebsi:1  marzouki:0  
8,10,9,169,1,243,108,300,0,192,108,300,0,0,104,3,1,108,0,1814,1845,True,69,35,sebsi:1  marzouki:1  
8,10,9,168,1,208,64,300,0,236,64,300,0,0,61,2,1,64,0,1800,1900,True,36,25,sebsi:1  marzouki:1  
8,10,8,167,1,168,52,200,0,148,52,200,0,0,51,0,1,52,0,1805,1827,True,44,7,sebsi:1  marzouki:1  
8,10,8,166,1,406,148,496,0,348,148,496,0,0,140,7,1,148,0,1805,1900,True,103,37,sebsi:1  marzouki:1  
8,10,7,165,1,314,118,400,0,282,118,400,0,0,116,2,0,118,0,1810,1840,True,98,18,sebsi:1  marzouki:1  
8,10,7,164,1,315,104,400,0,296,104,400,0,0,99,2,3,104,0,1810,1840,True,65,34,sebsi:1  marzouki:1  
8,10,6,163,1,585,208,700,0,492,208,700,0,0,203,4,1,208,0,1800,1855,True,152,51,sebsi:1  marzouki:1  
8,10,5,162,2,347,73,400,1,326,73,400,0,0,73,0,0,73,0,1805,1830,True,54,19,sebsi:1  marzouki:1  
8,10,5,162,1,347,155,400,1,244,155,400,0,0,146,8,1,155,0,1800,1840,True,128,18,sebsi:1  marzouki:1  
8,10,3,160,1,102,44,200,0,156,44,200,0,0,42,2,0,44,0,1820,1835,True,28,14,sebsi:1  marzouki:0  
8,10,3,159,1,353,105,400,1,294,105,400,0,0,103,2,0,105,0,1835,1930,True,59,44,sebsi:1  marzouki:1  
8,10,2,158,1,439,177,500,0,323,177,500,0,0,176,1,0,177,0,1805,1850,True,142,34,sebsi:1  marzouki:1  
8,10,1,157,2,343,163,400,0,237,163,400,0,0,160,1,2,163,0,1805,1840,True,105,55,sebsi:1  marzouki:0  
8,10,1,157,1,343,234,400,0,166,234,400,0,0,226,6,2,234,0,1820,1910,True,164,62,sebsi:1  marzouki:1  
8,10,1,156,2,384,136,500,0,365,135,500,0,1,131,2,2,135,0,1800,1840,True,90,41,sebsi:1  marzouki:0  
8,10,1,156,1,384,223,500,0,277,223,500,0,0,214,5,4,223,0,1815,1900,True,174,40,sebsi:1  marzouki:1  
8,9,6,155,1,252,97,300,0,203,97,300,0,0,93,1,3,97,0,1805,1836,True,75,18,sebsi:2  marzouki:1  
8,9,6,154,1,458,264,500,0,235,264,499,1,0,255,6,3,264,0,1800,1830,True,193,62,sebsi:1  marzouki:1  
8,9,5,153,1,91,42,100,0,58,42,100,0,0,42,0,0,42,0,1800,1830,True,18,24,sebsi:1  marzouki:1  
8,9,5,152,1,343,130,400,0,270,130,400,0,0,124,6,0,130,0,1800,1845,True,104,20,sebsi:1  marzouki:1  
8,9,4,151,1,407,164,500,0,336,164,500,0,0,158,1,5,164,0,1805,1830,True,142,16,sebsi:1  marzouki:1  
8,9,4,150,1,463,194,500,1,305,194,500,0,0,189,4,1,194,0,1800,1846,True,117,72,sebsi:1  marzouki:1  
8,9,4,149,1,74,28,100,0,72,28,100,0,0,26,1,1,28,0,1810,1840,True,19,7,sebsi:1  marzouki:0  
8,9,3,148,1,229,75,300,0,225,75,300,0,0,74,1,0,75,0,1800,1900,True,67,7,sebsi:1  marzouki:0  
8,9,3,147,1,551,333,600,0,267,333,600,0,0,326,7,0,333,0,1800,1915,True,253,73,sebsi:1  marzouki:0  
8,9,2,146,4,474,204,500,0,296,204,500,0,0,199,5,0,204,0,1810,1910,True,112,87,sebsi:1  marzouki:1  
8,9,2,146,3,475,263,500,0,237,263,500,0,0,255,2,6,263,0,1810,1910,True,165,90,sebsi:1  marzouki:1  
8,9,2,146,1,475,304,500,1,195,304,500,0,0,288,10,6,304,0,1822,1915,True,228,60,sebsi:1  marzouki:1  
8,9,1,145,2,347,182,402,0,220,182,402,0,0,176,3,3,182,0,1800,1840,True,96,80,sebsi:1  marzouki:1  
8,9,1,145,1,348,232,400,0,168,232,400,0,0,225,2,5,232,0,1820,1900,True,160,65,sebsi:1  marzouki:1  
8,9,1,144,3,418,217,500,0,283,217,500,0,0,212,0,5,217,0,1800,1910,True,126,86,sebsi:1  marzouki:1  
8,9,1,144,2,419,274,504,0,230,274,504,0,0,271,2,1,274,0,1800,1835,True,173,98,sebsi:1  marzouki:1  
8,9,1,144,1,419,287,500,0,213,287,500,0,0,278,5,4,287,0,1500,1850,True,216,62,sebsi:1  marzouki:1  
8,9,1,143,3,559,277,600,0,323,277,600,0,0,265,6,6,277,0,1800,1912,False,164,101,sebsi:1  marzouki:1  
8,9,1,143,2,561,378,600,0,222,378,600,0,0,369,1,8,378,0,1815,1852,True,254,115,sebsi:1  marzouki:1  
8,9,1,143,1,561,353,600,2,245,353,600,0,0,335,14,4,353,0,1820,1925,True,254,81,sebsi:1  marzouki:1  
8,2,5,37,1,446,259,496,0,237,259,496,0,0,246,13,0,259,0,1810,1915,True,167,79,sebsi:1  marzouki:1  
8,2,4,36,1,151,65,200,0,135,65,200,0,0,62,2,1,65,0,1800,1850,True,50,12,sebsi:1  marzouki:1  
8,2,3,35,1,114,31,200,0,169,31,200,0,0,31,0,0,31,0,1800,1820,True,26,5,sebsi:1  marzouki:0  
8,2,3,34,1,214,97,300,1,202,97,300,0,0,94,1,2,97,0,1800,1830,True,84,10,sebsi:1  marzouki:0  
8,2,3,33,1,84,42,100,0,58,42,100,0,0,41,0,1,42,0,1805,1840,True,37,4,sebsi:1  marzouki:0  
8,2,2,32,2,310,151,400,2,247,151,400,0,0,148,3,0,151,0,1800,1845,True,107,41,sebsi:1  marzouki:1  
8,2,2,32,1,311,198,400,0,202,198,400,0,0,190,7,1,198,0,1800,1900,True,159,31,sebsi:1  marzouki:1  
8,2,1,31,1,485,277,600,1,322,277,600,0,0,272,1,4,277,0,1800,1900,True,164,108,sebsi:1  marzouki:1  
8,2,1,30,1,188,90,200,0,110,90,200,0,0,85,3,2,90,0,1810,1830,True,48,37,sebsi:1  marzouki:1  
8,2,1,29,4,489,189,600,1,410,189,600,0,0,182,8,0,190,1,1800,1905,True,128,54,sebsi:1  marzouki:0  
8,2,1,29,3,491,232,600,1,367,232,600,0,0,224,4,4,232,0,1800,1900,True,168,56,sebsi:1  marzouki:0  
8,2,1,29,2,491,280,600,0,320,280,600,0,0,271,4,5,280,0,1800,1900,True,206,65,sebsi:1  marzouki:0  
8,2,1,29,1,491,301,600,0,299,301,600,0,0,288,12,1,301,0,1804,1900,True,235,53,sebsi:1  marzouki:0  
8,6,6,95,1,300,110,400,0,290,110,400,0,0,105,0,5,110,0,1800,1840,True,87,18,sebsi:1  marzouki:0  
8,6,6,94,1,354,113,400,0,287,113,400,0,0,110,1,2,113,0,1800,1835,True,84,26,sebsi:1  marzouki:0  
8,6,5,93,1,443,146,500,0,354,146,500,0,0,142,3,1,146,0,1800,1840,True,115,27,sebsi:1  marzouki:0  
8,6,4,92,1,281,132,300,0,168,132,300,0,0,131,1,0,132,0,1810,1845,True,81,50,sebsi:1  marzouki:0  
8,6,4,91,1,179,72,200,0,128,72,200,0,0,69,2,1,72,0,1800,1900,True,43,26,sebsi:1  marzouki:1  
8,6,4,90,1,122,54,200,1,145,54,200,0,0,48,4,2,54,0,1800,1830,True,45,3,sebsi:1  marzouki:1  
8,6,3,89,1,327,136,400,0,264,136,400,0,0,133,3,0,136,0,1805,1835,True,78,55,sebsi:1  marzouki:1  
8,6,2,88,2,549,234,600,1,365,234,600,0,0,219,11,4,234,0,1830,1900,True,104,115,sebsi:1  marzouki:1  
8,6,2,88,1,550,348,600,1,251,348,600,0,0,338,7,3,348,0,1901,1901,True,223,115,sebsi:1  marzouki:1  
8,6,2,87,4,511,186,600,0,414,186,600,0,0,181,3,2,186,0,1810,1837,True,101,80,sebsi:1  marzouki:1  
8,6,2,87,3,512,249,600,0,351,249,600,0,0,242,1,6,249,0,1810,1855,True,164,87,sebsi:1  marzouki:1  
8,6,2,87,2,512,299,600,1,300,299,600,0,0,290,2,7,299,0,1810,1900,True,199,91,sebsi:1  marzouki:1  
8,6,2,87,1,512,350,601,0,251,350,601,0,0,335,10,5,350,0,1815,1846,True,264,71,sebsi:1  marzouki:0  
8,6,2,86,4,494,191,600,0,409,191,600,0,0,179,10,2,191,0,1810,1845,True,114,65,sebsi:1  marzouki:0  
8,6,2,86,3,496,259,600,0,341,259,600,0,0,252,2,5,259,0,1820,1900,True,176,76,sebsi:1  marzouki:1  
8,6,2,86,2,496,322,600,1,277,322,600,0,0,312,5,5,322,0,1800,1845,True,226,86,sebsi:1  marzouki:0  
8,6,2,86,1,496,359,600,0,241,359,600,0,0,340,14,5,359,0,1810,1855,True,260,80,sebsi:1  marzouki:0  
8,6,2,85,2,561,255,600,1,344,255,600,0,0,249,2,4,255,0,1800,1855,True,171,78,sebsi:1  marzouki:1  
8,6,2,85,1,561,411,600,2,187,411,600,0,0,399,8,4,411,0,1800,1850,True,317,82,sebsi:1  marzouki:1  
8,6,1,84,1,429,169,500,1,330,169,500,0,0,164,4,1,169,0,1815,1845,True,132,32,sebsi:1  marzouki:1  
8,6,1,83,1,330,177,400,0,223,177,400,0,0,171,2,4,177,0,1810,1900,True,97,74,sebsi:0  marzouki:1  
8,4,8,71,1,176,97,200,0,103,97,200,0,0,93,2,2,97,0,1800,1850,True,77,16,sebsi:1  marzouki:1  
8,4,8,70,1,275,145,300,0,155,145,300,0,0,137,7,1,145,0,1810,1845,True,119,18,sebsi:1  marzouki:1  
8,4,7,69,1,88,46,100,0,54,46,100,0,0,44,0,2,46,0,1800,1825,True,39,5,sebsi:1  marzouki:0  
8,4,7,67,1,335,114,400,0,286,114,400,0,0,109,4,1,114,0,1805,1853,True,66,43,sebsi:1  marzouki:1  
8,4,6,66,1,151,65,208,0,143,65,208,0,0,60,3,2,65,0,1800,1900,True,45,15,sebsi:1  marzouki:1  
8,4,6,65,1,284,149,300,1,150,149,300,0,0,142,5,2,149,0,1810,1845,True,108,34,sebsi:1  marzouki:1  
8,4,5,64,1,331,126,401,0,275,126,401,0,0,122,4,0,126,0,1815,1840,True,99,23,sebsi:1  marzouki:0  
8,4,4,63,1,305,128,400,0,272,128,400,0,0,114,10,4,128,0,1800,1855,True,94,20,sebsi:1  marzouki:1  
8,4,4,62,1,360,150,400,0,250,150,400,0,0,149,1,0,150,0,1810,1827,True,101,48,sebsi:1  marzouki:1  
8,4,3,61,1,381,150,500,0,350,150,500,0,0,141,8,1,150,0,1800,1845,True,110,31,sebsi:1  marzouki:1  
8,4,2,60,1,172,90,200,0,110,90,200,0,0,86,3,1,90,0,1800,1850,True,68,18,sebsi:1  marzouki:1  
8,4,2,59,1,145,54,200,0,146,54,200,0,0,52,2,0,54,0,1810,1830,True,45,7,sebsi:1  marzouki:1  
8,4,1,58,1,118,68,200,0,132,68,200,0,0,66,0,2,68,0,1810,1900,True,55,11,sebsi:1  marzouki:1  
8,4,1,57,3,314,249,600,1,350,249,600,0,0,237,9,3,249,0,1800,1900,True,158,79,sebsi:1  marzouki:1  
8,4,1,57,2,515,384,600,0,216,384,600,0,0,377,1,6,384,0,1808,1940,True,293,84,sebsi:1  marzouki:1  
8,4,1,57,1,515,372,600,4,224,372,600,0,0,352,18,2,372,0,1815,1930,True,280,72,sebsi:1  marzouki:1  
8,4,1,56,3,497,280,600,0,320,280,600,0,0,271,8,1,280,0,1815,1905,True,180,91,sebsi:1  marzouki:1  
8,4,1,56,2,498,345,600,0,255,345,600,0,0,334,3,8,345,0,1820,1920,True,245,89,sebsi:1  marzouki:1  
8,4,1,56,1,498,333,600,1,266,333,600,0,0,324,9,0,333,0,1825,1900,True,260,64,sebsi:1  marzouki:1  
